--------------------------------
--------------------------------
--------------------------------
--------------------------------
--------------------------------
---------------------------SQS--
--------------------Q----SS-----
--------------SQ----------------
-----------------------------X--
--------------------------------
-------------XXX---<>-->--------
-----<>--<>-XXX----[]--<>--<>-X-
--{--[]--[]XXXXX---[]--[]--[]XX-
XXXXXXXXXXXXXXXXXXXXXXXXXXXXXXXX
