--------------------------------
--------------------------------
--------------------------------
---------------------Q----------
--------------------------------
---S----------------------------
-----------S--------------------
------------------Q----S--------
--SS----------------------------
------------X-------------------
-----------XXX------------X-----
-----<>---XXX---------<>-XX--}--
--{--[]--XXXX--X------[]XXX--X--
XXXXXXXXXXXXXXXXXXXXXXXXXXXXXXXX
