--------------------------------
--------------------------------
--------------------------------
---------------------Q----------
--------------------------------
--------------------------S-----
-----------Q----------S---------
--------------------------------
--------------------------------
--------------X-----------------
------------XXX-----------------
-----<>----XXXXXX-----<>--X--}--
--{--[]---XXXXXXX-----[]--X--X--
XXXXXXXXXXXXXXXXXXXXXXXXXXXXXXXX
