--------------------------------
--------------------------------
-------------------------SSSQ---
--------------------------------
-----------------Q--------------
--------------------Q-----------
------------------------Q-------
-------------S------------------
--------------------X-----------
--------SQ----------XXXXXX------
---------------X----XXXXXX------
----------<>---XXX--XXXXXX---}--
--{-------[]---XXX--XXXXXX---X--
XXXXX---XXXXXXXXXX-XXXXXXXXXXXXX
