--------------------------------
--------------------------------
--------------------------------
--------------------------------
--------------------------------
--------------------------------
--------------------------------
-----------------------S--------
--------------------------------
--------------------------------
--------------------------------
-----<>----XX---------<>-XX-----
--{--[]----XX---------[]XXX-----
XXXXXXXXXXXXX--XXXXXXXXXXXXXXXXX
