--------------------------------
--------------------------------
--------------------------------
------------------------S-------
--------------QS------------Q---
--------------------------------
--------------------------------
-------------------------Q------
--------------------------------
--------------------------------
-----<>----X-----<>-------------
-----[]----X-----[]-------X-----
--{--[]----XX----[]------XXX----
XXXXXXXXXX-XX--XXXXXXXXXXXXXXXXX
