--------------------------------
--------------------------------
--------------------------------
--------------------------------
--------------------------------
---------------------Q----QSQ---
-------------------------SS-----
--------------X-----------------
-------------XXX-------------X--
------------XXX-----------------
-----------XXXXX------<>--------
-----------XXXXX------[]-----}--
--{--[----XXXXXXX-----[]-----X--
XXXXXXXXXXXXXXXXXXXXXXXXXXXXXXXX
