--------------------------------
--------------------------------
--------------------------------
------------------------S-------
---------------Q------------Q---
--------------------------------
--------------------------------
-----------------S------SQ-S----
----------------------Q---------
--------------------------------
-----------------<>---Q---------
------<]---------[]-------}-----
---{--[]---------[]-------X-----
XXXXXXXXXX----XXXXXXXX--XXXXXXXX
