--------------------------------
--------------------------------
----SSS-------------------------
--------------------------------
----------------S--S------------
--------------------------------
--------------------------------
--SSQS--------------------SQ----
--------------------------------
-----------S--------------------
-X----<>------------------------
-XX---[]--------<>-X---<>---}---
-XXX--[]--------[]-----[]---X---
XXXXXXXXXX----XXXXXXXXXXXXXXXXXX
