--------------------------------
--------------------------------
--------------------------------
--------------------------------
--------------------------------
--------------------------------
--------------------------------
--------------------------------
--------------------------------
--------------------------------
------<>---X----<>--------------
------[]---X-----[--------}-----
--{---[]---X-----]--------X-----
XXXXXXXXXXXXX-XXXXXXXXXXXXXXXXXX
