--------------------------------
--------------------------------
--------------------------------
--------------------------------
-----------------SQ---------Q---
--------------------------------
--------------------------------
-------------------------Q------
----------------------S-Q-------
------------------X-------------
-----------------XX-------------
------------<>---XX-------}--}--
--{---------[]--XXX-----X-X--X--
XXXXXXX---XXXXXXXXXXXX--XXXXXXXX
