--------------------------------
--------------------------------
--------------------------------
--------------------------------
------------------S-------------
------S-S-----------------------
--------------------------------
--------------------------------
-----S-SSQ---------Q----Q-------
---Q----------------------------
--------------------------------
------<>----<>---X----------}---
---{--[]----[]--XXX---------X---
XXXXXXXXXXXXXXXXXX------XXXXXXXX
