--------------------------------
--------------------------------
--------------------------------
--------------------------------
--------------------------------
---S----------------------Q--S--
---------S-S-X-----------S------
------------------Q-------------
--SS---------X------------------
------------XXX-----------------
-----------XXXX-------<>--------
-----<>---XXXXX-------[]-----}--
--{--[]--XXXXXXX------[]-----X--
XXXXXXXXXXXXXXXXXXXXXXXXXXXXXXXX
