--------------------------------
--------------------------------
--------------------------------
------------------------S-------
---------------QX-Q---------Q---
--------------------------------
--------------------------------
-----------------S------SQ-S----
----------------------Q---------
--------------------------------
-----------------<>-------------
------------<>---[]-------}-----
------------[]---[]-------X-----
XXXXXXX----XXXXXXXXXXX--XXXXXXXX
