--------------------------------
--------------------------------
--------------------------------
--------------------------------
--------------------------------
---------------------------SQS--
--------------------Q----SS-----
---------------Q----------------
-----------------------------X--
--------------------------------
-------------XXX---<>-->--------
-----<>--<>-XXXX---[]--]---<>}X-
--{--[]--[]-XXXX---[]--[]--[]XX-
XXXXXXXXXXXXXXXXXXXXXXXXXXXXXXXX
