--------------------------------
--------------------------------
--------------------------------
---------------------Q----------
--------------------------------
--------------------------------
-----S-----S--------------------
------------------Q----S--------
--Q-----------------------------
--------------------------------
------------X-------------X-----
-----<>----XXX--------<>-XX--}--
--{--[]---XXXX--------[]XXX--X--
XXXXXXXXXXXXXXXXXXXXXXXXXXXXXXXX
