--------------------------------
--------------------------------
---SSSSSS-S---------------------
--------------------------------
---------------SS--S------------
-------Q------------------------
--------------------------------
--SSQQS---------S---S-----SSSQ--
--------------------------------
-X---------S----------S---------
-X--------------------SS--------
-XXX--<]--------<>-X------------
-XXX--[]--------[]----------X---
XXXXXXXXXX----XXXXXX----XXXXXXXX
