--------------------------------
--------------------------------
--------------------------------
--------------------------------
--------------------------------
---------------------------S----
-------------------------SS-----
---------------Q----------------
----------------------------QX--
--S------------X----------------
--------------XX---<>-----------
-----<>--<>--XXX---[]--------}--
-----[]--[]-XXXX---[]--------XX-
XXXXXXXXXXXXXXXXXXXXXXXXXXXXXXXX
