--------------------------------
--------------------------------
--------------------------------
--------------------------------
--------------------------------
--------------------------------
----QQ--------------------------
--------QS--S--Q----------------
--------------------------------
--------------------------------
--------------------------------
-----------<>----------<>---}---
---{-------[]----------[]---X---
XXXXXXXXXXXXXXXX---XXXXXXXXXXXXX
