--------------------------------
--------------------------------
--------------------------------
-------------------------SS-----
-----Q--------------Q-Q---------
---------SQSS-Q-----------------
-----------------------QSSQSS---
----S---------------------------
--------Q---Q----Q--------------
--------------------------------
----------X--S------------------
------<>-XX-----<>---<>------}--
--{---[]XXX-----[]---[]------X--
XXXXXXXXXXXXXXXXXXXXXXXXXXXXXXXX
