--------------------------------
--------------------------------
--------------------------------
--------------------------------
--------------------------------
---------S--S------SQS----------
-------------------------SSSQ---
--------------------------------
-------SSS---Q-SQQSQ------------
--------------------------------
-----------------------XX-------
------<>--<>---<>-----XXXX--}---
---{--[]-XX----[]----XXXXXX-X---
XXXXXXXXXXX--XXXXXXXXXXXXXXXXXXX
