--------------------------------
--------------------------------
--------------------------------
--Q----S----SQ------------------
------------------S-------------
--------------------------------
--------------------------------
-----------S--------------------
-----S-------------S------------
--------------------------------
-------------X------------------
-----<>--<>-XX-----XX--<>--}----
--{--[]--[]XXX----XXX--[]--X----
XXXXXXXXXXXXX----XXXXXXXXXXXXXXX
