--------------------------------
--------------------------------
--------------------------------
--Q-----------------------------
------------------S-------------
----SQS-------------------------
--------------------------------
--------------------------------
-----S--------------------------
--------------------------------
-------------Q------------------
-----<>--<>--------<>--<>----}--
--{--[]--[]--------[]--[]----X--
XXXXXXXXXXXXX----XXXXXXXXXXXXXXX
