--------------------------------
--------------------------------
-------------------------Q------
--------S-----------------------
----------QSSS-S---------Q------
----------------------S---------
--------------------------------
------Q-------S--S---S-----SS---
------------------------S-------
---------SS-------X-------------
-----------------XX-------------
-----<>-X----<>-XXX--<>---}-----
--{--[]X-----[]XXXX--[]---X-----
XXXXXXXXX--XXXXXXXXXXXXXXXXXXXXX
