--------------------------------
--------------------------------
--------------------------------
--------------------------------
--------------------------------
------------------SSQS----------
--------------------------------
--------------------------------
-------S-SS---------S-----------
-----------------------X--------
-----------------------XX-------
------<>-------<>--<>--XX---}---
---{--[]-------[]--[]--XX---X---
XXXXXXXXXXXXXXXXXXXXXXXXXXXXXXXX
