--------------------------------
--------------------------------
--------------------------------
--------------------------------
---------------------S----------
--------------------------------
----------------------------Q---
--------------------------------
-------SS---------S-------------
--------------------------------
-----------------------X--------
-----<>--<>----<>---<>-XX----}--
--{--[]--[]----[]---[]XXX----X--
XXXXXXXXXXXXXXXXXXXXXXXXX--XXXXX
