--------------------------------
--------------------------------
--------------------------------
--S----SS-----------------------
--------------SQQ--------Q------
--------------------------------
--------------------------------
-----------S---------------SSS--
-------------------S------------
--------------------X-----------
-------------X-----XX-----------
-----<>------XX---XXX--<>--}----
--{--[]-----XXX--XXXX--[]--X----
XXXXXXXXXXXXXXX--XXXXXXXXXXXXXXX
