--------------------------------
--------------------------------
--------------------------------
--Q----S------------------------
--------------SQ--S-------------
--------------------------------
--------------------------------
----------------------------SS--
-----S-------------S------------
--------------------------------
-------------------X------------
-----<>--<>---X---XX---<>----}--
--{--[]--[]--XX--XXX---[]----X--
XXXXXXXXXXXXXXXXXXXXXXXXXXXXXXXX
