--------------------------------
--------------------------------
--------------------------------
--------------------------------
-----------S----Q---------------
----------------------S---------
--------------------------------
-------------------Q-------SS---
------------SS------------------
------------------XX------------
-----------------XXX------------
-----<>--<>--<>-XXXX--<>-XX--}--
--{--[]--[]--[]XXXXX--[]XXX--X--
XXXXXXXXXXXXXXXXXXXXXXXXXXXXXXXX
