--------------------------------
--------------------------------
--------------------------------
--------------------------------
-----------S--------------------
--------------------------------
--------------------------------
-------------------Q--------Q---
------------SS------------------
-------------------X------------
------------------XX------------
---------<>---<>-XXX--<>-XX--}--
--{------[]---[]XXXX--X]XXX--X--
XXXXXXXXXXXXXXXXXXXXXXXXXXXXXXXX
