--------------------------------
--------------------------------
----------------S---------------
-------------------------S------
------------SS--------Q--Q------
--S-----------------------------
--------------------------------
-----SQ----------SS--S----------
-----------S-------------S------
-----Q--------------------------
--------------------------------
-------X----<>--XX---<>---}-----
----{-XX----[]--XX---[]---X-----
XXXXXXXXX--XXXXXX---XXXXXXXXXXXX
