--------------------------------
--------------------------------
--------------------------------
--------------------------------
--------------------------------
------------------SSQS----------
--------------------------------
--------------------------------
-------S--S----Q----------------
--------------------------------
-----------------------XX-------
------<>--<>---<>--<>--XXX--}---
---{--[]--[]---[]--[]--XXX--X---
XXXXXXXXXXXXXXXXXXXXXXXXXXXXXXXX
