--------------------------------
--------------------------------
--------------------------------
---------S-SS-SQ----------------
--------------------------------
--------------------S----SQS---X
--------------------------------
----------------S---------------
--Q-----------------------------
-------------------Q------------
------SQ-------<>---------------
---------------[]------XX---}---
---------------[]-----XXXX--X---
XXXXXXXXX----XXXXXXX--XXXXXXXXXX
