--------------------------------
--------------------------------
--------------------------------
------------S-SQ----------------
--------------------------------
--------------------SQ--SS------
------------S-S-----------------
--------------------------------
---------------------SQ---------
-----------------------X--------
------------S--<>------XX-------
---------------[]----XXX-----}--
---{-----------[]---XXXX-----X--
XXXXXXXX-----XXXXXXXXXXXXXXXXXXX
