--------------------------------
--------------------------------
--------------------------------
---------------S----------------
-----S--------------------------
--------------------------------
--S-----------------------------
--------------------------------
--------------------------------
---SQ---------------------------
--------XX---<>-----------------
------XXXX---<>--X--------}-----
--{--XXXXX---[]--X----XXX-X--X--
XXXXXXXXX--XXXXXXXXX--XXXXXXXXXX
