--------------------------------
--------------------------------
--------------------------------
---------Q--------Q--S----------
-----SS-------------------------
--------------S-----------------
-----------------S--------------
---SS-----X-------------Q-------
---------XX----------------S----
--------XXXX-----X-XX-----------
-------XXXX------XXXX--SQ-------
------XXXX---XX--XXXX------}----
--{--XXXXX---XX--XXXX------X----
XXXXXXXXXXXXXXXXXXXXX--XXXXXXXXX
