--------------------------------
--------------------------------
--------------------------------
----Q---------------------------
-------------------------S------
----------------S--Q------------
-S-----------X------------------
------------XX----------S--QS---
----S------XXX------------------
----------XXXX------X---------->
---------XXXXX-X---XX--Q-Q----->
--------XXXXX--XX--XX-----<>----
----{--XXXXXX--XXX-XX-----[]----
XXXXXXXXXXXXX--XX--XX---XXXXXXXX
