--------------------------------
--------------------------------
--------------------------------
--------------------------------
---------------S---------SS-----
--------------------------------
--------------------------------
--------------------------------
--------------------------------
---------XX---------------------
--------XXX---------------------
-------XXXX-----<>---------}----
----{-XXXXX-----[]XX-------X----
XXXXXXXXXXXXXXXXXXXX--XXXXXXXXXX
