--------------------------------
--------------------------------
-------------------SSQ---SS-----
---------SSSSQS-----------------
--------------------------------
X-XX---------------------QSSQS--
---Q-SQ-------------------------
----------------S---------------
--Q-------------------Q------S--
-------------------Q------------
-----SSQ--S----<>---------------
---------------[]----XXX----}---
--{------------[]---XXXX----X---
XXXXXXXXX-XX-XXXXXXXXXXX--XXXXXX
