--------------------------------
--------------------------------
--------------------------------
--------------------------------
--------------------------S-----
--------------------------------
--------------------------------
--------------------------------
--------------------------------
----Q------------X--------------
-----------------XX-------------
-------------<>>-XX---------}---
--{----XX----[]-XXX---------X---
XXXXX--XX--XXXXXXXXX--XXXXXXXXXX
