--------------------------------
--------------------------------
--------------------------------
--------------------------------
--------------------------------
--------------------------------
----------Q---------------------
--------------------------------
-------------X------------SSQ---
-----------XXX------------------
-----------XXX-----XX-----------
-----<>----XXX----XXX------}----
--{--[]----XXXX--XXXX------X----
XXXXXXXXXXXXXXXXXXXXXXXXXXXXXXXX
