--------------------------------
--------------------------------
--------------------------------
--------------------------------
-----Q------------S-------------
---------------------Q----------
--------S-------------------S---
------------SSS--SQ-------------
--------------------------------
----Q------------------XX-------
----------------------XXX-------
----------------<>---XXXXX---}--
---{----S-------[]--XXXXX----X--
XXXXXXXXX----XXXXXXXXXXXXXXXXXXX
