--------------------------------
--------------------------------
--------------------------------
----Q---------------------------
-------------------------S------
----------------S--Q------------
-S-----------X------------------
------------XX----------S--QS---
----S------XXX------X-----------
----------XXXX-----XX-----------
---------XXXX--X---XX--QSQ------
-----<>-XXXXX--XX--XX-----<>----
--{--[]-XXXXX--XXX-XX------X----
XXXXXXXXXXXXX--XX-XXX---XXXXXXXX
