--------------------------------
--------------------------------
--------------------------------
--------------------------------
--------------------------------
--------------------------------
--------------------------------
--------------------------------
--------------------------------
------------------Q---XXX-------
---------------------XXXX-------
--------------<>-----XXXX----}--
--{-----------[]----XXXXX----X--
XXXXX-----XXXXXXXX---XXXXXXXXXXX
