--------------------------------
--------------------------------
--------------------------------
--------------------------------
--------------------------------
-----------------------S--------
--------------------------------
----------XX--------------------
---------XXX---------------S----
------X--XXX----S---------------
------X--XXX--------------------
------XXXXXXX-------------}-----
--{---XXXXXXXX------------X-----
XXXXXXXXXXXXXXXXXXXXX----XXXXXXX
