--------------------------------
--------------------------------
-----------------------Q--------
--------------------------------
-----Q--------------------------
-------------------S------------
----S--S------------------------
------------SS--SS-----X--------
----------------------XX--------
---SQ-----------------XXX-------
---------------------XXXX-------
--------------<>->--XXXXX----}--
--------------[]XX-XXXXXX----X--
XXXXX--X---XXXXXXXXX-XXXXXXXXXXX
