--------------------------------
--------------------------------
--------------------------------
--------------------------------
--------------------------------
--------------------------------
--------------------------------
----------------Q---------------
--------------------------------
--------------------------------
--------------------------------
-------]-----<>------X----}-----
---{--[]-----[]-----XX----X-----
XXXXXXXXXXXXXXXXXXXXXX-XXXXXXXXX
