--------------------------------
--------------------------------
--------------------------------
-----Q--------------------------
--------------------------------
--------S------Q---SS-------S---
--------------------------------
-----------------------Q--------
---------------Q----------SSQ---
--S---S-------------------------
-----------X---<>--SQ-----------
-----------XX--[]------<>----}--
--{--------XX--[]------[]----X--
XXXXX----XXXXXXXXXXXXXXXXXXXXXXX
