--------------------------------
--------------------------------
--------------------------------
--------------------------------
-------SS-----------------------
-----------SSQQ--QS-------------
--------------------------------
----SS--------------------X-----
-------------------------XX-----
---------------X---Q----XXX-----
--------------XX------XXXXX-----
-----<>---<>-XXX------XXXXX--}--
--{--[]---[]XXXX-----XXXXXX--X--
XXXXXXXXXXXXXXXXX---XXXXXXXXXXXX
