--------------------------------
--------------------------------
--------------------------------
--------------------------------
-------------------S------------
--------S-----------------------
-----S----------------------S---
--------------QS------S---------
---------Q----------------Q--S--
--Q-----------------------------
------------------<-------------
-----------<>-----<>--<>-----}--
---{---[]--[]-----[]--[]-----X--
XXXXXXXXXXXXXX-XXXXXXXXXXXXXXXXX
