--------------------------------
--------------------------------
----------------------------S---
--------------------------------
-----------------SQ---S--Q------
-----SSQS-----------------------
-------------------------Q------
------------Q-----------S-------
----S----S------------------Q---
---------------<>---------------
---------------[>---------------
---------------[]------<>--}----
--{------XX----[]------[]--X----
XXXXXXXXXXXXXXXXXXXXXXXXXXXXXXXX
