--------------------------------
--------------------------------
----------------------------SS--
--------------------------------
------------------Q-------------
----------S---------------------
----------------------------S---
-------------S-SQ---------------
----QQ----S---------------------
--------------------------------
------<>------------------------
------[]--<>-<>---<>---<>--}----
--{---[]--[]-[]---[]---[]--X----
XXXXXXXXXXXXXXXXXXXXXXXXXXXXXXXX
