--------------------------------
--------------------------------
--------------------------S-----
---------------------S----------
--------------------------------
----S------------S-------S------
--------------------------------
--------------------------------
----------------X---S--Q--------
---Q-----------XX---------------
-----X--------XXX---------X-----
------X------XXXX--XX----XX--}--
--{--XXX----XXXXX--XX---XXX--X--
XXXXXXXXXXXXXXXXXXXXXXXXXXXXXXXX
