--------------------------------
--------------------------------
--------------------------------
-----------------S--------------
---SQ------------------Q--------
--------------------------------
--------------------------------
-----------------S--------S-----
---QSQ--SQS---------------------
--------------------------------
-----------------S--------------
------<>--}----------------}----
--{---[]--X----------------X----
XXXXXXXXXXXXXXXXXXXXXX--XXXXXXXX
