--------------------------------
--------------------------------
---------------------------SSQ--
-------S------------------------
---Q-------------Q--------------
-----------------------S--------
--------------------------------
---------------S----------------
---S--Q-------------------------
------------------X-------------
-----------------XX-------------
-------<>----<>-XXX--X----}-----
---{---[]----[]XXXX--X----X-----
XXXXXXXXXXX--XXXXXX--XX-XXXXXXXX
