--------------------------------
--------------------------------
--------------------------------
-----Q--------------------------
--------------------------------
-----S--S----------S------------
-----S--------------------------
--------------QS------S---------
---------Q---------------Q--Q---
--Q--SS-------------------------
---------------X----------------
-----------<>--X--<}---<>----}--
---{-------[]--X---X---[]----X--
XXXXXXXXXXXXXXXXXXXXXXXXXXXXXXXX
