--------------------------------
--------------------------------
------------------------SS------
--------------------------------
--------------------------------
--------------------------------
------------------Q----------S--
---------------------Q----------
-----------SSS-----------X------
------------------------XX------
-----------------------XXX------
-----<>--<>-----<>----XXXX--}---
--{--[]--[]-----[]---XXXXX--X---
XXXXXXXXXXXXXXXXXXXXXXXXXXXXXXXX
