--------------------------------
--------------------------------
--------------------------------
--------------------------------
-------SQ-----------------------
------------QQ------------------
--------------------------------
--------------------------------
----------S---------------------
---------------X----------------
--------------XX----------------
------<>--<>-XXX--<>--<X-----}--
--{---[]--[]XXXX--[]--[X-----X--
XXXXXXXXXXXXXXXXXXXXXXXXXXXXXXXX
