--------------------------------
--------------------------------
--------------------------------
------------------Q-------------
----------------------------SQ--
--------------------------------
----------------SQQ----------S--
--------------------------------
-----------S--------------------
--------------------------------
------------------------X-------
-----<>-------------<>-XX-------
--{--[]-------------[]XXX-------
XXXXXXXXXXXXXXX--XXXXXXXX--XXXXX
