--------------------------------
--------------------------------
--------------------------------
------------------SS------------
-----S--------------------------
--------------------------------
----------------S---------------
-------Q--------------------SS--
--------------------------------
--------------------------S-----
-------------X------------------
------------XX---<>---XX-----}--
-----------XXX---[]--XXX-----X--
XXXXXXXXXXXXXXXXXXXXXXXXXXXXXXXX
