--------------------------------
--------------------------------
--------------------------------
--------------------------------
--------------------------------
--------------------------------
------------------Q-------------
---------------------Q----------
--------------------------------
--------------------------------
--------------------------------
-----<>---------<>--<>----------
--{--[]---------[]--[]----------
XXXXXXXXXXXXXXXXXXXXXXXX--XXXXXX
