--------------------------------
--------------------------------
-------------------Q------------
---------------------SQ---------
--------------------------------
--S-----------------------------
--------------------------------
---------S----------------------
--Q---------------------QS------
----------------XX--------------
---------------XXX--------------
-----<>----<>--XXX--<>---XX-----
--{--[]----[]XXXXX--[]---XX-----
XXXXXXXXXXXXXXXXXXXXXXXXXXXXXXXX
