--------------------------------
--------------------------------
--------------------------------
--------------------------------
-------------------S------------
-----S--------------------------
--------------------------------
--------------Q-----------------
---------Q----------------Q--S--
--------------------------------
--------------------------------
------<>----------<>--<>--}--}--
---{--[]----------[]--[]--X--X--
XXXXXXXXXXXXX--XXXXXXX-XXXXXXXXX
