--------------------------------
--------------------------------
--------------------------------
--------------------------------
--------------------------------
-----------SSQ------------------
-----------------SQ-------------
-------S-----------------SSQ----
--------------------------------
--------------------------------
-----------------XX---XX--------
-----<>-X-<--<>-XXX---[]---}----
--{--[]XX-[--[]XXXX---[X---X----
XXXXXXXXXXXXXXXXXXXXXXXXXXXXXXXX
