--------------------------------
--------------------------------
--------------------------------
--------------------------------
--------------------------------
--------------------------------
--------------------------------
--------------------------------
--------------------------------
--------------------------------
--------------------------------
----------<>-----------------}--
--{-------[]-----------------X--
XXXXX----XXXX-------XXXX---XXXXX
