--------------------------------
--------------------------------
--------------------------------
--------------------------------
--------------------------------
--------------------------------
--------------------------------
--------------------------------
---S----------------------------
--------------------------------
--------------------------------
-----------<>------<>--------}--
---{-------[]------[]--------X--
XXXXXXXXXXXXXXXXXXXXXXXX---XXXXX
