--------------------------------
--------------------------------
--------------------------------
--------------------------------
--------------------------------
--------------------------------
--------------------------------
--------------------------------
----------------SQ--------------
-------------------S------------
----------X---------------------
--------XXX--XX--------------}--
--{-----XXXXXXXX-------------X--
XXXXXXXXXXXXXX-------------XXXXX
