--------------------------------
--------------------------------
--------------------------------
--------------------------------
--------------------------------
-----------------SS--SS---------
--------------------------------
--------------------------------
-------------S------------------
--------------------------------
--------------------------------
-----<>-------------<>-------}--
--{--[]-------------[]-------X--
XXXXXXXXX---------XXXXXXXXXXXXXX
