--------------------------------
--------------------------------
--------------------------------
--------------------------------
--------------------------------
--------------------------------
--------------------------------
--------------------------------
-----------------------X--------
----S----------------XXXX-------
-------XXXXX---------XXXX-------
--------XXXX-->------XXXXX---}--
--{-{---XXXX-X]X-----XXXXX---X--
XXXXX---XXXXXXXXXX---XXXXXXXXXXX
