--------------------------------
--------------------------------
--------------------------------
--------------------------------
---------------S----------------
---------------------SS---------
--------------------------------
--------------------------------
------S-----SSSSSQ--S-----------
--------------------------------
--------------------------------
-----------<>-------<>---X---}--
--{--{-----[]-------[]--XXX--X--
XXXXXXXXXXXXXXXXXXXXXXXXXXXXXXXX
