--------------------------------
--------------------------------
--------------------------------
----------------SQ--------------
--------------------------------
------------------SQ------------
------------SQ---------SQ-------
--SQSQ---SQ---}-}--S------------
--------------X---S-------------
-----XX-------------------------
-------------S------------------
------<>--------<>------XX------
--{---[]--------[]-------XX-----
XXXXXXXXXX----XXXXXXXX---XXXXXXX
