--------------------------------
--------------------------------
--------------------------------
--------------------------------
--------------------------------
--------------------------------
--------------------------------
--------------------SSSQ----S---
--------------------------------
--------------------------------
-------------------->-----------
------<>---<>---<>-XX---X--X----
---{--[]---[]---[]-X]---X--XX---
XXXXXXXXXXXXXXXXXXXXX-XXXXXXXXXX
