--------------------------------
--------------------------------
--------------------SS----------
-------------S------------------
----------------S---------------
---------------------------SS---
--------------------------------
----------Q---------------------
----------------------Q---------
-----X-------------->-----------
-----X----S-SS->---<>-----------
-----XX>-----------[]---X-------
--{--XXX-------X---[]-------X---
XXXXXXXXX-----XXXXXXXXX---XXXXXX
