--------------------------------
--------------------------------
--------------------------------
--------------------------------
--------------------------------
--------------------------------
--------------------------------
--------------------------------
--------------------------------
--------------------------------
-------XX-----------------------
--------XXX---<>-----X-------}--
----{---XXX---[]-----X-------X--
XXXXXXXXXXXXXXXXXX---XXXXXXXXXXX
