--------------------------------
--------------------------------
-------------------SSS----------
--------------------------------
----------------S---------------
--------------------------------
--------------------------------
----------------------SQ--------
-------------------------SSSS---
--------------------------------
--------------<>---XX---------Q-
------XX------[]---XX-------X---
---{--XXX-----[]--XXX-------X---
XXXXXXXXXXXXXXXXXXXXXXX--XXXXXXX
