--------------------------------
--------------------------------
--------------------------------
--------------------------------
---------------S----------------
--------------------------------
--------------------------------
--------------------------------
-----SS------S--SQ----SQ-SSQ----
--------------------------------
--------------------------------
-----<>---->--X----<--<>--------
--{--[]---[---X----[--[]-XX-X---
XXXXXXXXX----------XXXXXXXXXXXXX
