--------------------------------
--------------------------------
--------------------------------
--------------------------------
-------------------------S------
--S-----------------------------
--------------------------------
--------------------------------
------------------SQQS----------
--------------------------------
---------<>--XX--------X--------
-----<>--[]--XX-------XX--}-----
--{--[]--[]-XXX------XXX--X-----
XXXXXXXXXXXXXXX--XXXXXXXXXXXXXXX
