--------------------------------
--------------------------------
--------------------------------
----------------------Q---------
---Q----------------------------
----SQ-------------------QQ-QS--
-----------------S--Q-----------
--------------------------------
-------S--------------Q---------
-----------X--------------------
----------XXX-------------------
------<>-XXXX----XX--<>--XX-----
---{--[]XXXXX---XXX--[]--XX-----
XXXXXXXXXXXXXXXXXXXXXXXXXXXXXXXX
