--------------------------------
--------------------------------
----------------------S---------
--------------------------------
--------------------SQ----------
--------------------------------
--------------------------------
--------------------------------
--------------XX---S------------
-------------XXX----------------
-------------XXX----------<>----
-----<>--<>-XXXX-----<>---[]--<-
-----[]--[]XXXXX-----[]---[]--[-
XXXXXXXXXXXXXXXX--XXXXXXXXXXXXXX
