--------------------------------
--------------------------------
--------------------------------
--------------------------------
--------------------------------
--------------------------------
--------------------------------
-------------------------S------
--------------------------------
--------------------------------
------------Q-------------------
-----<>----------------<>---}---
--{--[]----------------[]---X---
XXXXXXXXXXXX--XXXXXXXXXXXXXXXXXX
