--------------------------------
--------------------------------
--------------------------------
--------------------------------
--------------------------------
--------------------------------
--------------------------------
----------------------------SS--
--------------------------------
--S-----------------------------
---------<>------------<>-------
---------[]--------<]--[]--}----
--{------[]---X----[]--[]--X----
XXXXXXXX-XXXXXXX--XXXXXXXXXXXXXX
