--------------------------------
--------------------------------
--------------------------------
--------------------------------
--------------------------------
--------------------------------
--------------------------------
--------------------------------
--------------------------------
--------------------------------
---------X----------------------
-----<>-XX---XX----<>-------}---
--{--[]XXX--XXX----[]-------X---
XXXXXXXXXXXXXXXXXXXXXXXXXXXXXXXX
