--------------------------------
--------------------------------
--------------------------------
-----S--------------------------
------------Q------S-S----------
-------------------------Q------
-----S--------------------------
-----------------S---SQ---------
--S-----------------------------
-----------X--------------------
----------XXX-------------X-----
------<>---XX----X---<>-XXX--}--
--{---[]--XXX---XXX--[]-XXX--X--
XXXXXXXXXXXXX--XXXXXXXXXXXXXXXXX
