--------------------------------
--------------------------------
--------------------------------
--------------------------------
--------------------------------
--------------------------------
--------------------------------
------S-------------------------
-------------S------------------
---S----------------------------
------S--------X---<>-----------
-----------<>--XX--[]-----}--}--
---{-------[]--XX--[]-----X--X--
XXXXXXXXXXXXXXXXXXXXXXXXXXXXXXXX
