--------------------------------
--------------------------------
--------------------------------
--------------------------------
------SQSSS---------------------
--------------------S-----------
--------------------------------
--------------------------------
--------S-------------Q-----S---
-------------SS-------X---------
---------X------------XX--------
-----<>-XX-----------XXX--------
-----[]XXX-------X--XXXX--------
XXXXXXXXXXXXXXXXXXXXXXXXXXXXXXXX
