--------------------------------
--------------------------------
--------------------------------
--------------------------------
--------------------------------
--------------------------------
--------------------------------
--------------------------------
--------------------------------
--------------------------------
--------------------------------
------XX----<>----XX--<>-----}--
--{---XX----[]---XXX--[]-----X--
XXXXXXXXXXXXXXXXXXXXXXXXXXXXXXXX
