--------------------------------
--------------------------------
--------------------------S-SSS-
-----S----------------S---------
---------S--Q-------------------
---S----------------------------
--------------------Q-----------
------------------------XXX-----
-----------X------------XX------
----------XX---------X-XXXX-----
----------XX---Q----XXXXXXX-----
------<>-XXXX------XXXXXXXX--}--
--{---[]XXXXX----XXXXXXXXXX--X--
XXXXXXXXXXXXX--XXXXXXXXXXXXXXXXX
