--------------------------------
--------------------------------
--------------------------S-SS--
-----S--------------------------
------------Q------S------------
-------------------------SQ-Q---
-----S--------------------------
-----------------S---S-S--------
--------------------------------
-----------X--------------------
----------XX--------------X-----
------<>-XXX-----XX---<--XX--}--
--{---[]XXXXX---XXX---[]XXX--X--
XXXXXXXXXXXXX---XXXXXXXXXXXXXXXX
