--------------------------------
--------------------------------
--------------------------------
-----S--------------------------
------------------Q---------S---
--------------------------------
--------------------------------
----------------SQ-QQ-----------
--------------------------S--S--
--------------------------------
------<>------------<>--X-------
------[]---XX-------[]--XX---}--
------[]---XX-------[]--X----X--
XXXXXXXXXXXX-----X--X-X----XXXXX
