--------------------------------
--------------------------------
--------------------------------
--------------------------------
--------------------------------
--------------------------------
--------------------------------
--------------------------------
--------------------------------
---------------X----------------
--------------XXX----<>---------
------<>---XXXXXX----[]---------
---{--[]-XXXXXXXX----[]---X-----
XXXXXXXXXXXXXXXXXXXXXXXXXXXXXXXX
