--------------------------------
--------------------------------
--------------------------------
--------------------------------
--------------------SS----------
---------------Q----------------
--------------------------------
--------------------------------
---------------X-------------S--
--------------XX----------------
------<>-----XXX----------<>----
------[]----XXXXX---<>----[]----
---{--[]---XXXXXX---[]X---[]----
XXXXXXXXXXXXXXXXXXXXXXXXXXXXXXXX
