--------------------------------
--------------------------------
--------------------------------
--------------------------------
--------------------SS----------
--------------------------------
----------------S---------------
---------------------SQ---------
-----------XXX------------------
-----------XXXX---Q-------------
----------XXXXX-----------<>----
------<>-XXXXXX------<>---[]----
--{---[]XXXXXXXX-----[]---[]----
XXXXXXXXXXXXXXXXXXXXXXXXXXXXXXXX
