--------------------------------
--------------------------------
--------------------------S-SSS-
-----S----------------S---------
---------S----------------------
---S-----------S-------------S--
--------------------Q----X------
-----------------------XXXX-----
--S-------------------XXXXX-----
-----------X----SQ---XXXXXX-----
----------XXX-------XXXXXXX-----
------<>--XXX-------XXXXXXX--}--
--{---[]--XXX------XXXXXXXX--X--
XXXXXXXXXXXXXXXXXXXXXXXXXXXXXXXX
