--------------------------------
--------------------------------
--------------------------------
--------------------------------
------------Q-------------------
--------------------------------
-------S------------------Q-----
-----------S--SQS--Q---S--------
--------------------------------
--S-----------------------------
-------------------X------------
------XX----<>----XX--<>-X---}--
--{{-XXX----[]---XXX--[]XX---X--
XXXXXXXX--XXXXXXXXXXXXXXXXXXXXXX
