--------------------------------
--------------------------------
-----------------------------S--
----------------------S---------
---------S--------------S-------
--------------------------------
--------------------Q-----------
-----------------------XX-------
-----------------------XXX------
---------------------XXXX-------
---------X----SQ----XXXXXX------
-----<>-XXX--------XXXXXXX---}--
--{--[]XXXX-------XXXXXXXX---X--
XXXXXXXXXXXX---XXXXXXXXXXXXXXXXX
