--------------------------------
--------------------------------
--------------------------------
---------S----------------------
--QS--SQ--Q---------------------
--------------------------------
------------------SS-----QQ-----
-----------SQ---S-----S---S-----
--------S-----------------------
--------------------------------
-------------------X--<>--------
--------<>--[]----XX--[]-----}--
----{---[]--[]---XXX--[]-----X--
XXXXXXXXXXXXXXXXXXXXXXXXXXXXXXXX
