--------------------------------
--------------------------------
--------------------------------
--------------------------------
-----------S--------------S-----
--------------------------------
---S--------------------Q-------
-------------------S------------
-------S------------------------
--------------XX----------------
-------------XXXXX------XX------
-----<>--<>--XXXXX-----XXX---}--
--{--[]--[]--XXXXX---]XXXX---X--
XXXXXXXXXXXXXXXXXXXXXXXXXXXXXXXX
