--------------------------------
--------------------------------
--------------------------------
--------------------------------
--------------------------------
--------------------------------
--------------------------------
--------------------------------
--------------------S-----------
--------------------------------
--------------------------------
------<>-XX--<>---<>--<>-XX--}--
--{---[]XXX--[]---[]--[]XXX--X--
XXXXXXXXXXXXXXXXXXXXXXXXXXXXXXXX
