--------------------------------
--------------------------------
--------------------------------
--------------------------------
--------------------------------
--------------------------------
--------------------------------
--------------------------------
---------------Q----------------
--------------------------------
--------------------------------
------------<>----<>--<>--}-----
------------[]----[]--[]--X-----
XXXXXXXXXXXXXXXXXXXXXXXXXXXXXXXX
