--------------------------------
--------------------------------
--------------------------------
--------------------------------
--------------------------------
--------------------------------
--------------------------------
--------------------------------
--------------------------------
--------------------------------
--------------------------------
-----<>--<>--------<>--<>-------
--{--[]--[]-X--XX--[]--[]-------
XXXXXXXXXXXXXXXXXXXXXXXXXXXXXXXX
