--------------------------------
--------------------------------
--------------------------------
--------------------------------
--------------------------------
------SS--SSSQ------------------
-----------------------------Q--
--------------------------------
----SS-------------SSSQ---------
--------------------------------
--------------------------------
-----<>--<>-------<>--<>-----}--
--{--[]--[]-------[]--[]-----X--
XXXXXXXXXXXXXXXXXXXXXXXXXXXXXXXX
