--------------------------------
--------------------------------
--------------------------------
--------------------------SS----
--------------------------------
------------SS-----SQ-----------
--------------------------------
----------------------------SS--
--------------------S-----------
--------------------------------
--------------------------XX----
------<>-----<>---<>--<>-XXX-}--
------[]-----[]---[]--[]XXXX-X--
XXXXXXXXXXXXXXXXXXXXXXXXXXXXXXXX
