--------------------------------
--------------------------------
---------------SS---------------
--------------------------SS----
---S----Q-----------------------
--S----------SQS----------------
--------------------------------
--------------------------------
---S--S--S----SQ--QS-SS---------
--------------------------------
----------------------------X---
------------<>----XX--<>---XX---
---{--------[]---XXX--[]---XX---
XXXXXXXXXXXXXXXXXXXXXXXXX--XXXXX
