--------------------------------
--------------------------------
---------------S----------------
--------------------------------
--------Q-----------------------
-------------SQS----------------
--------------------------------
--------------------------------
------S--S-----Q---S------------
--------------------------------
--------------------------------
------<>----<>----<X--<>--}-----
---{--[]----[]----XX--[]--XX----
XXXXXXXXXXXXXXXXXXXXXXXXXXXXXXXX
