--------------------------------
--------------------------------
--------------------------------
--------------------------------
--------------------------------
--------------------------------
--------------------------------
--------------------------------
--------------------------------
--------------------------------
--------------------------------
---------<>-X------<>--<>-------
--{------[]XX------[]--[]-------
XXXXXXXXXXXXXX---XXXXXXXXXXXXXXX
