--------------------------------
--------------------------------
---------------Q----------------
--------------------------------
---S----------------------------
------------S-Q-----------------
--------------------------------
--------------------------------
---S----SS-SS------S-SS---------
--------------------------------
--------------------------------
-----------<>--<>-XX--<>----}---
-----------[]--[]XXX--[]---XX---
XXXXXXXXXXXXXXXXXXXXXXXXXXXXXXXX
