--------------------------------
--------------------------------
--------------------------------
--------------------------------
--------------------------------
--------------------------------
--------------------------------
---------------Q----------------
---S----SS-SS----S-Q------------
--------------------------------
--------------------------------
-----------<>--<>------<>---}---
--{--------[]--[]-XX---[]---X---
XXXXXXXXXXXXXXXXXXXXXXXXXXXXXXXX
