--------------------------------
--------------------------------
--------------------------------
--------------------------------
--------------------------------
--------------------------------
--------------------------------
---------S---Q------------------
--------------------------------
--------------------------------
--------------------------------
------<>--------------<--XX--}--
--{---[]-------XX-----[]XXX--X--
XXXXXXXXXXXXXXXXX--XXXXXXXXXXXXX
