--------------------------------
--------------------------------
--------------------------------
--------------------------------
------------------------Q--Q----
------------------SQ------------
--------------------------------
---------S--SQ--------------S---
----------------Q-------SQ------
--------------------------------
--------------------------------
-----<>-----<>-------<>-XXX-----
--{--[]-----[]-------[]-XXX-----
XXXXXXXXXXXXXXXX---XXXXXXXXXXXXX
