--------------------------------
--------------------------------
--------------------------------
--------------------------------
--------------------------------
--------------------------------
--------------------------------
--------------------------------
--------------------------------
--------------------------------
--------------------------X-----
-----<>--<>-----XXX---<>-XX--}--
--{--[]--[]-X--XXXX---[]XXX--X--
XXXXXXXXXXXXXXXXXXXXXXXXXXXXXXXX
