--------------------------------
--------------------------------
--------------------------------
--------------------------------
--------------------------SQ----
--------------------------------
--------------------------------
---------S--SQS----S------------
----------------Q-------SQ------
--------------------------------
-------------------------X------
-----<>--------}X----<>-XXX--}--
--{--[]-------XXX----[]XXXX--X--
XXXXXXXXXXXXXXXXX--XXXXXXXXXXXXX
