--------------------------------
--------------------------------
--------------------------------
--------------------------------
--------------------------------
-----SSS---SSQ------------------
--------------------------------
--------------------------------
-----SQ------------SSSQ---------
--------------------------------
--------------------------------
---------<>--<>---<>--<>----}---
--{------[]--[]---[]--[]----X---
XXXXXXXXXXXXXXXXXXXXXXXXXXXXXXXX
