--------------------------------
--------------------------------
--------------------------------
--------------------------------
------S-------------------------
---------------Q--Q-------------
--------------------S-----------
----------S-----------Q---------
---------------Q----------------
--------------------------------
--------------------------------
------<>--------<>--------}-----
---{--[]--------[]--------X-----
XXXXXXXXXXX--XXXXXXXXXXXXXXXXXXX
