--------------------------------
--------------------------------
--------------------------------
-----------------------S--------
---------S--S-------------------
--------------------------------
--SS--------------------QSSSSQ--
--------------------------------
-------S--S---------------------
--------------------------------
--------------S-----------------
-----<>--<>-XX----->---<>----}--
-----[]--[]XX------]]--[]----X--
XXXXXXXXXXXXXX---XXXXXXXXXXXXXXX
