--------------------------------
--------------------------------
---------------QS---------------
--------------------------------
--------------------------------
-----------SSS------------------
--------------------------------
--------------------------------
-------------S-----S-SS---------
--------------------------------
----------------------------X---
------<>--<>---<--<>--<<>---}---
------[]XX[]---[--[]--[[----X---
XXXXXXXXXXXXXXXXXXXXXXXXXXXXXXXX
