--------------------------------
--------------------------------
--------------------------------
--------------------------------
--S-S---S-----------------------
--------------------------------
--------------------------------
-------SSQ----------------------
-------------Q---S-----S--S-----
--------------------------------
-----<>-------------------------
-----[]---------<>--<>-------}--
--{--[]---------[]--[]-------X--
XXXXXXXXXXXXXXXXXXXXXXXXXXXXXXXX
