--------------------------------
--------------------------------
--------------------------------
------------------S------Q-SS---
--------------------------------
--------S-S---------------------
------------------QSS--S-----S--
----------------------------S---
--------------------------------
--SQ--X----S--------------------
------<S-------SS--------Q------
------[]---------------------}--
------[]------------[X-------X--
XXXXXXXXXXXXXXXXXXXXXXXXXXXXXXXX
