--------------------------------
--------------------------------
--------------------------------
--------------------------------
-----------Q--------------------
--------------------------------
--------------------------------
----QSQ---Q--SSS-SQS---Q--------
--------------------------------
--------------------------------
-----S-------SS-S--------X------
-------------------<>--XXX--}---
--{----------------[]-XXXX--X---
XXXXX-----XX--XX-XXXXXXXXXXXXXXX
