--------------------------------
--------------------------------
----------------QQ--------------
--------------------------------
------------Q-------------------
--------------------------------
--------------------------------
-------S--SSS-------------------
-----------------------------Q--
--------------------------------
--------------------------------
--------<>---<>----<>--<>---}---
--{--{--[]---[]----[]--[]---X---
XXXXXXXXXXXXXXXXXXXXXXXXXXXXXXXX
