--------------------------------
--------------------------------
-------S--Q--Q------------SQ----
--------------------------------
----S--S------------------------
----------S---------------S-----
--------------------------------
----------------S---------------
----------------------------Q---
--------------------->--QQ------
------<>--------<>--<>----------
------[]--<>----[]--[]-------}--
--{---[]--[]----[]--[]-------X--
XXXXXXXXXXXXXXXXXXXXXXXXXXXXXXXX
