--------------------------------
--------------------------------
-------S--SQ-QQ-----------SQ----
--------------------------------
--S-S--S------------------------
-------------S----SQ-------SS---
--------------------------------
--------------------------------
-----------------S--------------
--------------------------------
--------------------XX----------
-----<>---<>----<>--XX-----}----
--{--[]---[]----[]XXXX-----X----
XXXXXXXXXXXXXXXXXXXXXX--XXXXXXXX
