--------------------------------
--------------------------------
--------------------------------
--------------------------------
--------------------------------
--------------------------------
--SQ----SS----------------------
------------XX------------------
-----------XXX------------------
----------XXXX--------X---------
---------XXXXX--------XX--------
-----<>-XXXXXX--------XXX----}--
-----[]XXXXXXX--------XXXX---X--
XXXXXXXXXXXXXXXXXXXX--XXXXXXXXXX
