--------------------------------
--------------------------------
--------------------------------
--------------------------------
-------------------------Q------
----Q---------------------------
-------------------SSS----------
-------Q--------Q---------------
----------------X---------------
--Q-------S---------------------
------------S-------------------
---------------<>-XX---<>----}--
--{--{---------[]XXX---[]----X--
XXXXXXXXX--XXXXXXXXXXXXXXXXXXXXX
