--------------------------------
--------------------------------
--------------------------------
--------------------SQ----------
-----Q-----------S--------------
--------------------------------
--------SSS---------------------
--------------SS----------------
---------------------X----------
-S--SS-SQ------------X----------
-----------X---------XXX--------
----------XX---------XXXX---}---
---{------XX---------XXXXX--X---
XXXXXX--XXXXXXX---X--XXXXXXXXXXX
