--------------------------------
--------------------------------
--------------------------------
--------------------------------
--------S-------------------SS--
------------QS------------------
--------------------------------
--------------------------------
------QQ---S-SSS-S------SSSS----
--------------------------------
--------------------------------
-----<>--<>--<>-XX-----<>--}----
--{--[]--[]--[]XXX-----[]--X----
XXXXXXXXXXXXXXXXXXXXXXXXXXXXXXXX
