--------------------------------
--------------------------------
--------------------SS----------
-----------------S--------------
------------------------S-------
--Q------------------S----------
--SQ-----Q----------------------
------------XXX-----------------
------------XXX-----------------
------------XXX-<---------------
-----------XXXX-[]---QS---------
-----<>---XXXX--[]-------X---}--
--{--[]--XXXXX--[]XX-----XX--X--
XXXXXXXXXXXXXXXXXXXX-----XXXXXXX
