--------------------------------
--------------------------------
--------------------------------
-------------------------Q------
----SSQS--------------Q---------
----------------SS--------------
-----------------------S--------
--------------------------------
-------------Q------------------
------X------------------Q------
------XX------------<>---S------
------XX--<>---<>---[]------}---
---{-XXX--[]---[]---[]------X---
XXXXXXXXXXXXXXXXXXXXXXXXXXXXXXXX
