--------------------------------
--------------------------------
--------------------------------
--------------------------------
--------------------------------
-------------S-----S---S-S--SQ--
--------------------------------
-------------------------S------
-----------SSSQ-----------------
--------------------------------
--------------------------------
-----<>--<>--<>--<>--X-----}----
--{--[]--[]--[]--[]XXX-----X----
XXXXXXXXXXXXXXXXXXXXXX--XXXXXXXX
