--------------------------------
--------------------------------
--------------------------------
-----------------SS-------------
--------------------------------
--------------------------------
------------------QQ------------
----------------------------S---
----------------X---------------
----------------XX--------------
-----<>------X--XX--------------
-----[]-----XX--XX-----<>----}--
--{--[]----XXX--XX-----[]----X--
XXXXXXXXXXXXXX-XXXX--XXXXXXXXXXX
