--------------------------------
--------------------------------
--------------------------------
--------------------------------
--------------------------------
---------------SSSQ-------------
--------------------------------
--------------------------------
----------S------------S--------
--------------------------------
-----X--------------------------
-----XX--------<>--<>--------}--
--{--XXX--X----[]--[]--------X--
XXXXXXXXXXXXXXXXXXXXXXXX---XXXXX
