--------------------------------
--------------------------------
--------------------------------
--------------------------------
--------------------------------
--S---------S----------S---SSS--
--------------------------------
-------------------------S------
----Q--------SQS--S--------SS---
----------X---------------------
---------XX-------------X-------
--------XXX--<>---<>-X--X----}--
--{----XXXX--[]---[]XX-------X--
XXXXXXXXXXXXXXXXXXXXXX--XXXXXXXX
