--------------------------------
--------------------------------
--------------------------------
-------------S------------------
--------------------------------
--------------------------------
--------------------------------
--------------------------------
----------S---------------------
--------------------------------
--------------------------------
------<>----------<>--<>--}---<-
------[]X---------[]--[]--X---[-
XXXXXXXXXX------XXXXXXXXXXXXXXXX
