--------------------------------
--------------------------------
--------------------------------
-------------------------S------
-----------------S--------------
---------------------Q----------
----S--------Q------------------
----------------SQ--------------
----------------------Q---------
--------------------------------
------<>-------SQ---------------
------[]----X-------------}-----
---{--[]---XXX------------X-----
XXXXXXXXXXXXXX--XX-----XXXXXXXXX
