--------------------------------
--------------------------------
--------------------------------
--------------------------------
--------------------------------
-------------------SQ-----------
--------------------------------
--------------------------------
------------------------S--S----
--------------------------------
--------------------------------
-----<>--<>--<>--<>--X-----}----
--{--[]--[]--[]--[]-XX-----X----
XXXXXXXXXXXXXXXXXXXXXX--XXXXXXXX
