--------------------------------
--------------------------------
--------------------------------
--------------------------------
--------------------------------
--------------------------------
--------------------------------
--------------------------------
-----------------Q--------------
--------------------------------
---------XX--------X------------
---------XX----<>--XXXX------}--
--------XXX----[]--XXXXX-----X--
XXXXXXXXXXXXXXXXXXXXXXXX---XXXXX
