--------------------------------
--------------------------------
--------------------------------
--------------------------------
----------------S---------------
--------------------------------
--------------------------------
-----------------------Q--------
------------------QQ------------
--------------------------------
--------------------------------
------<>----<>----<>----XX--}---
--{---[]----[]----[]---XXX--X---
XXXXXXXXXXXXXXXXXXXXXXXXXXXXXXXX
