--------------------------------
--------------------------------
--------------------------------
--------------------------------
--------------------------------
--------------SQ----------------
--------------------------------
---------S----------------------
----QS--------QS----------------
--------------------------------
--------------------------------
---------<>----<>------<>----}--
---------[]----[]------[]----X--
XXXXX--XXXXXXXXX---XXXXXXXXXXXXX
