--------------------------------
--------------------------------
--------------------------------
--------------------------------
---SQ---------------------------
---------SS---------------SQS---
--------------------------------
--------------------X-----------
--S----------------XX-------S---
------------------XXX-----------
-----------------XXXX-----------
-----<>--<>--<>-XXXXXX-----}----
--{--[]--[]--[]XXXXXXX-----X----
XXXXXXXXXXXXXXXXXXXXXXXXXXXXXXXX
