--------------------------------
--------------------------------
----------------S---------------
--------------------------------
--------------------------------
---------------S----------------
--------------------------------
--------------------------------
--------------------------------
--------------------------------
--------------------------------
-------<>----<>---<>---<>----}--
----{--[]----[]---[]---[]----X--
XXXXXXXXXXXXXXXXXXXXXXXXXXXXXXXX
