--------------------------------
--------------------------------
-------------S------------------
--------------------------------
---------------------------SS---
--------------------------------
--------------------------------
--------------------------------
---------------S--QQ------------
--------------------------------
--------------------------------
------<>--<>--<>--<>---<>----}--
---{--[]--[]--[]--[]---[]----X--
XXXXXXXXXXXXXXXXXXXXXXXXXXXXXXXX
