--------------------------------
--------------------------------
--------------------------------
--------------------------------
--------------------S--------S--
--------------------------------
--------------------------------
------S--SSSS------------SSSQ---
---------------S----SQQ---------
--------------------------------
--------------------------------
------<>--<>-----------<>----}--
---{--[]--[]-----------[]----X--
XXXXXXXXXXXXXX------S------SXXXX
