--------------------------------
--------------------------------
--------------------------------
--------------------------------
--------------------------------
--------------------------------
--------------------------------
---------SS---------------------
--------------SS----------------
--------------------------------
--------------------------------
-----<>--<>---------<>-------}--
--{--[]--[]---------[]-------X--
XXXXXXXXXXXXXXXXXXXXXXXXXXXXXXXX
