--------------------------------
--------------------------------
--------------------------------
--------------------------------
--------------------------------
-----QQ------SQS----------------
--------------------------------
--------------------------------
---SQSQ-------------------------
--------------------------------
--------------------------------
-----<>--XX---<>-----<>->----}--
--{--[]--XX---[]XX---[]------X--
XXXXXXXXXXXXXXXXXXX--XXXXXXXXXXX
