--------------------------------
--------------------------------
--------------------------------
--------------------------------
--------------------------------
--------------------------------
--------------------------------
--------------------------------
--------------------------------
----------------------X---------
---------X------------XXX-------
-----<>-XX---<>---XX---XX---}---
--{--[]XXX---[]---[]--XXX---X---
XXXXXXXXXXXXXXXXXXXXXXXXXXXXXXXX
