--------------------------------
--------------------------------
-------------S--SQ--------------
---------------------SS---------
--------------------------------
--------------SS----------------
----------------------S---------
--------------------------------
--------------------------S-----
--------------------------------
--------------------------------
-------<------<>--<>--<>--}-----
---{----------[]--[]--[]--X-----
XXXXXXXXXXXXXXXXXXXXXXXXXXXXXXXX
