--------------------------------
--------------------------------
--------------------------------
--------------------------------
--------------------------------
---------------------------SS---
--------------------------------
--------------------------------
--------------------------------
--------------------------------
---------X---------XX-----------
-----<>-XX---<>---XXX--XX-------
--{--[]XXX---[]---XXX--XX-------
XXXXXXXXXXXXXXXXXXXXXXXXXXXXXXXX
