--------------------------------
--------------------------------
--------------------------------
--------------------------------
--------------------------------
--------------------------------
--------------------------------
--------S-----------------------
-------------SS-----SSQ---------
--------------------------------
--------------------------------
-----<>--<>----<>---<>-------}--
--{--[]--[]----[]---[]-------X--
XXXXXXXXXXXXXXXXXXXXXXXXXXXXXXXX
