--------------------------------
--------------------------------
--------------------------------
--------------------------------
--------------------------------
--------------------------------
--------------------------------
--------------------------------
--------------------------------
--------------------------------
--------------------------------
-----<>--<>-<>------<-----}--}--
--{--[]--[]-[]------[-----X--X--
XXXXXXXXXXXXXXXXXXXXXXXXXXXXXXXX
