--------------------------------
--------------------------------
--------------------------------
--------------------------------
--------------------------------
--------S-----------------------
--------------------------------
--------------------------------
----------SS-------X-------SS---
--------------------------------
-----------------X--------------
-----<>--<>--<>-XX----XX---}----
--{--[]--[]--[]XXX--XXXX---X----
XXXXXXXXXXXXXXXXXXXXXXXXXXXXXXXX
