--------------------------------
--------------------------------
--------------------------------
--------------------------------
---SQ---------------------------
----------------Q---------------
-------------------S-S--S-------
--------S-----------------------
-------------S--S---------------
---------------------X----------
--------------------XX----------
-----<>--<>----<>---XXX----}----
--{--[]--[]----[]---XXX----X----
XXXXXXXXXXXXXXXXXXXXXXXXXXXXXXXX
