--------------------------------
--------------------------------
--------------------------------
---S----------------------------
--------------------------------
------S---------QSQ-------------
------------------------S-------
----------------------------SQ--
---SQSQ---------S---------------
--------------------------------
--------------------------------
-----<>--<>----<>-X---X----}----
--{--[]--[]----[]XX---X----X----
XXXXXXXXXXXXXXXXXXX--XXXXXXXXXXX
