--------------------------------
--------------------------------
--------------------------------
----------------------------S---
----Q---------------------Q-----
--------------------------------
--------------------------------
--------SSSSS---------------SQ--
-------------S-S--SQ-Q----------
--------------------------------
--------------------------------
-----<>--<>----<>-XX---<>---}---
-----[]--[]----[]XXXX--[]---X---
XXXXXXXXXXXXXXXXXXXXXXXXXXXXXXXX
