--------------------------------
--------------------------------
--------------------------------
--------------------------------
--------------------------------
---------------------------S----
--------------------------------
--------------------------------
--------------------------------
--------------------------------
-------------------X------------
---------<>--<>---XX---XX--}----
--{------[]--[]---XX---XX--X----
XXXXXXXXXXXXXXXXXXXXXXXXXXXXXXXX
