--------------------------------
--------------------------------
--------------------------------
--------------------------------
-------------------Q--S---------
--------------------------------
--------------------------------
--------------------------------
----------S-------Q----------S--
--------------------------------
-------------------------XX-----
-----<>------<>---<>----XX---}--
--{--[]------[]---[]---XXXX--X--
XXXXXXXXXXXXXXXXXXXXXXXXXXXXXXXX
