--------------------------------
--------------------------------
--------------------------------
--------------S--S--------------
--------------------SS----------
--------------------------------
------------------Q-------------
-------Q--------------------S---
--------------------------------
-------------Q------------------
---------X------<>--SS----------
-----<>-XX------X]--------}-----
--{--[]XXX------[XX-------X-----
XXXXXXXXXX-----XXXXX------XXXXXX
