--------------------------------
--------------------------------
------S-------------------------
--------------------------------
-----------------QS-S-----S-----
--------------------------------
--S-------------------S---------
------------QS-----S-----SQS----
----SQ--------------------------
--------------------------------
-------XX-SQS---------Q---------
------XXX-------<>-------X---}--
--{--XXXX-------[]------XX---X--
XXXXXXXXX-----XXXXXXXXXXX--XXXXX
