--------------------------------
--------------------------------
--------------------------------
--S-SSQ-------------------------
--------------------------------
--------------Q-----------------
-----------------S--------------
-----SS----------Q--------------
---------X--------SQ-S----------
--------XXX---------------------
-------XXX---<>--S--------------
------XXXXX--[]-----------}--}--
--{--XXXXXX--[]-----------X--X--
XXXXXXXXXXXXXXXXX-------XXXXXXXX
