--------------------------------
--------------------------------
----Q------SQ-------------------
--------------------------------
--------------------------------
------QSQ-S-Q------------S-SSS--
--------------------------------
---------------------X----------
---------SSQS---Q----XX----S----
----S-SQ-------------XXX--------
---------------------XXXX-------
--------<>-----------XXXXX-}----
----{---[]-----------XXXXXXX----
XXXXXXXXXXXXXXX----XXXXXXXXXXXXX
