--------------------------------
--------------------------------
--------------------------------
--------------------------------
-----------------S--------------
--------------------------------
------------S-------------------
---SQ---------------------------
--------------------------------
--------------------------------
---------X-X--------------------
-----<>-XXXX---<>------------}--
--{--[]XXXXX---[]------------X--
XXXXXXXXXXXXXXXXXXXX-------XXXXX
