--------------------------------
--------------------------------
--------------------------------
--S-SSQ-------------------------
--S-----------------------S-----
--------------------------------
--------------------------------
-----------QS--S----------SQ----
--------------------------------
--------------------------------
-----XX-------------<>---X------
-----[]--------XX---[]-XXX------
--{--[]X-------XXX--[]-XXX------
XXXXXXXXX-----XXXXXXXXXXXXXXXXXX
