--------------------------------
--------------------------------
--------------------------------
----------S---------------------
--------------------------------
--------------------------------
----------Q---------------------
--------------------------------
---------------------S----------
--------------------------------
----------X------S--------------
------<>-XX------------------}--
---{--[]XXX------------------X--
XXXXXXXXXXX--------------XXXXXXX
