--------------------------------
--------------------------------
--------------------------------
--------------------------------
------------Q--S--Q-------------
---SQQ---------------S----------
---------------Q----------------
--------------------------------
-----------------------------S--
--------------------------------
-----------<>------<>-SQSQ------
-----<>----[]------[]-------}---
--{--[]----[]------[]-------X---
XXXXXXXXXXXXXXXXXXXXX-----XXXXXX
