--------------------------------
--------------------------------
--------------------------------
--------------------------------
-----------------SS-------------
---------------------S----------
-----------------------------S--
--------------------------------
-----SQS------------------------
--------------------------------
----------------------S---------
--------X--------------------}--
--{----XX--------------------X--
XXXXXXXXX------------------XXXXX
