--------------------------------
--------------------------------
--------------------------------
--------------------------------
--------------------------------
--------------------------------
--------------------------------
--------------------------------
--------------------------------
--------------------------------
-------------------------Q------
-----<>----<>--<>-----------}---
--{--[]----[]--[]-----------X---
XXXXXXXXXXXXXXXXXXXXXXX---XXXXXX
