--------------------------------
--------------------------------
----------------S---------------
--------------------------------
--------------------------------
-----SQSQ---Q------------S--SQ--
-------------------S------------
--------------------------------
-----------S----------X----SQQ--
------SQ-Q------------XXX-------
----------------------XXX-------
-----------<>---------XXXX------
--{--------[]---------XXXXX-----
XXXXX-------XXXXXXXXXXXXXXXXXXXX
