--------------------------------
--------------------------------
-----------S--------------------
--------------------------------
-----S--------------------------
--------Q----------------S-SSS--
----S----S----------------------
------------------------Q-------
--Q------------------X----------
--Q--X---------------XX---------
-----SX--------------XX---------
-----------<>-X---X--XXXX---}---
--{--------[]XX---XX-XXXXX--X---
XXXXXXXXXXXXXXX---XXXXXXXXXXXXXX
