--------------------------------
--------------------------------
--------------------------------
---------------Q----------------
-----SQ----SQ-------------------
--------------------------------
--------------------------------
----------S---XX----------------
--------------XXX-------SS------
--QQ--<>------XXXX--------S-----
------[]------XXXX--------------
------[]------XXXXX---<>----}---
------[]------XXXXXX--[]----X---
XXXXXXXXXXXXX-XXXXXXXXXXXXXXXXXX
