--------------------------------
--------------------------------
-----------S--------------------
--------------------------------
-----SQ------------Q------------
-----------Q-------------S--S---
-------------------S------------
------------------------Q-------
--------------S------------Q----
--SQSS------>-------------------
--------S---------Q-------------
-----------<>-----X---<>-----}--
--{--------[]-X---X---[]-----X--
XXXXX---XXXXXXX---XXXXXXXXXXXXXX
