--------------------------------
--------------------------------
--------------------------------
--S-SQ--------------------------
--------------------------------
------------S-------------------
----------------S---------------
---SQ---------------------------
------------------S-------------
----------XX--------------------
---------XXX--------------------
-----<>--XXX---<>---------}-----
--{--[]-XXXX---[]----X----X-----
XXXXXXXXXXXXXXXXXXX-XXXXXXXXXXXX
