--------------------------------
--------------------------------
--------------------------------
---------------------------S----
--------------------------------
--------------------------------
--Q-----------------------------
-------------S-S--S-------------
----------------------Q---X-----
-------------------Q------X-----
------------------------XXX-----
------------------------XXX--}--
---{-------------------XXXX--X--
XXXXXXX------X------XXXXXXXXXXXX
