--------------------------------
--------------------------------
--------------------------------
----------------------------S---
---------------SSQS-------------
---------------------S----------
---------------------------S----
-------------S------------------
---SS---------------------------
--------------------------------
-------------Q-----SS-----------
-------------------------X---}--
---{---------------------XX--X--
XXXXXXX---------------X-XXXXXXXX
