--------------------------------
--------------------------------
---------------S----------------
--------------------------------
--S-----------------------------
--------Q--Q-----Q------SS--SQ--
-----S-------------S------------
--------------------------------
--------------S-------X----SS---
-----X---Q------------XX--------
-----X--S----<>---Q---XXX-------
-------------[]--------XXX---}--
--{----------[]-------XXXXX--X--
XXXXX------XXXXXXX-XXXXXXXXXXXXX
