--------------------------------
--------------------------------
--------------------------------
--------------------------------
--------------------------------
--------Q-----------------------
-----------------------S--------
---------------SS---------------
--------S-----------------------
--------------------------------
---------------<>---------------
-----------<>--[]------------}--
----{{-----[]--[]------------X--
XXXXXXXXXXXXXXXXXXXXX-----XXXXXX
