--------------------------------
--------------------------------
--------------------------------
----------------------S---------
----SQ--------------------------
--------------------------------
----------------Q---------------
-------Q--Q--------------S-SQ---
--------------------------------
---------------X----Q-----------
---------------XX-------X-------
---------<>----XX-------XX---}--
-----{---[]----XX-------XXX--X--
XXXXXXXXXXXXXXXXXXXXXX--XXXXXXXX
