--------------------------------
--------------------------------
--------------------------------
--------------------------------
--------------------------------
----------------------Q--S------
--------------------------------
--------------------------------
--------------------------------
--------------------------------
------------------XX------------
-----------X-----XXX---------}--
--{{------XX----XXXX---------X--
XXXXXXXX--XX--XXXXXXX--XXXXXXXXX
