--------------------------------
-------------------Q------------
-----------SQ-------------------
--------------------------SQQ---
----------------------Q---------
----------Q--------Q------------
-------------------------QQ-Q---
--------------------------------
--------------------------------
--------------------------------
------------------SS------------
------<>--<>--X---------X---}---
--{---[]--[]XXX--------XX---X---
XXXXXXXXXXXXXXXXX-XXXXXXXXXXXXXX
