--------------------------------
--------------------------------
--------------------------------
--------------------------------
---------------S----------------
------S--S-S--------------------
--------------------------------
--------------------------------
--------------SS-Q------X---Q---
-----------------------XX-------
-----------X----------XXX-------
-------<>--XX-----<>-XXXX---}---
-------[]--XX-----[]XXXXX---X---
XXXXXXXXXXXXXXXXXXXXXXXXXXXXXXXX
