--------------------------------
--------------------------------
------------Q-------------------
---------S------------------Q---
--------------------------------
------------------S-------------
-------------------------SQSQQ--
--------------------------------
--------------------------------
--------------------------------
--------------------S-----------
------<>--<>----<>-----<>---}---
---{--[]--[]----[]-----[]---X---
XXXXXXXXXXXXXXXXXXXXXXXXXXXXXXXX
