--------------------------------
--------------------------------
--------------------------------
--------------------------------
--------------------------------
---------------S--SS--------Q---
--------------------------------
------S-Q-----------------------
------------------SS---Q--------
--------------------------------
-----<>-------------------------
-----[]------XX---<>--------}---
--{--[]-----XXX---[]--------X---
XXXXXXXXXXXXXXXXXXXXXX-XXXXXXXXX
