--------------------------------
--------------------------------
--------------------------------
-----------------------SQ-------
---------------S----------------
-----------S--------------------
--------------------------------
---------------S----------------
----QSSSQ-----SS----------------
--------------------------------
-----------X--------------X-----
-------<>--XX---<>-------XX--}--
--{----[]--XXX--[]------XXX--X--
XXXXXXXXXXXXXXXXXXXXXXXXXXXXXXXX
