--------------------------------
--------------------------------
--------------------------------
--------------------------------
----S---------------------S-----
--------------------------------
--------------------------------
-------------X-------------SS---
------------XX------------------
-----------XX-------Q-----------
----------X-X--X----------------
---------XXXXX--X-------XX---}--
-----{--XXXXXX---X-----XXXX--X--
XXXXXXXXXXXXXXXXXXXXXXXXXXXXXXXX
