--------------------------------
--------------------------------
--------------------------------
--------------------------------
-------------S---------------Q--
--------------------------------
--------------------------------
--------------------------------
--------------------------------
--------------------------------
---------<>---------<>----------
---------[]---------[]---XX--}--
---------[]----X----[]--XXX--X--
XXXXXXXXXXXXXXXXXXXXXXXXXXXXXXXX
