--------------------------------
--------------------------------
--------------------------------
---------------------SQ---------
--------------------------------
--------------------------------
--------------------------------
--------------------------------
------------S-------XX----------
--------------------XX----------
-------------------XXX----------
-----<>------<>---XXXX-----}----
--{--[]------[]--XXXXX-----X----
XXXXXXXXXXXXXXXXXXXXXX--XXXXXXXX
