--------------------------------
--------------------------------
--------------------------------
---------------------------S----
--------------------------------
--------------SQ----------------
---------------------------Q----
--------------------------------
--------------------S------Q----
-----<>---------S---------------
-----[]----------X--------------
-----[]---------XX--<>-----}----
--{--[]-------XXXX--[]-----X----
XXXXXXXXX---XXXXXXXXXXXXXXXXXXXX
