--------------------------------
--------------------------------
--------------------------------
---SQ---------------------------
----------------------SQ--------
--------------------------------
----S---------------------------
--------------------SQ----------
-------------S---S--------------
--Q--Q--------------------------
--------------S-----------------
----------<>-----X-----<>----}--
--{-------[]-----XX----[]----X--
XXXXX---XXXXXXX--X---XXXXXXXXXXX
