--------------------------------
--------------------------------
--------------------------------
------------------------Q-------
----------------S---Q-----------
-------------Q-------------S----
-------------------------S------
--------------------------------
---Q-SS----Q--SSS---------X-----
-------------------------XX-----
------------------------XXX-----
->----<>--}---------<>-XXX------
--{---[]--X--XX-----[]XXXX------
XXXXXXXXXXXXXXX--XXXXXXXXXXXXXXX
META {"type": "geom", "shape": "path", "group": "path", "data": [[12, 2, 12, 3], [12, 3, 12, 4], [12, 4, 10, 6], [10, 6, 10, 7], [10, 7, 9, 8], [9, 8, 10, 9], [10, 9, 11, 10]]}
