--------------------------------
--------------------------------
---------------------S----------
--------------------------------
--------------------------------
----------------------S---------
--------------------------------
---------S-----S----------------
-----------------------------Q--
----------------------X---------
----------------------XX--------
-----------[]--<>-----XXX----}--
---{-------[]--[]-----XXXX---X--
XXXXXXXXXXXXXXXXXXXX--XXXXXXXXXX
