--------------------------------
--------------------------------
--------------------------------
--------------------------------
---------------SQ---------S--S--
------S----S---------QS---------
--------------------------------
---------------S---------XX-----
-----S------------------XXX--Q--
------------X---------XXXXX-----
-----------XX---------XXXXX-----
-------<>-XXX---<>---XXXXXX--}--
----{--[]XXXXX--[]--XXXXXXX--X--
XXXXXXXXXXXXXXXXXXXXXXXXXXXXXXXX
