--------------------------------
--------------------------------
---------------S----------------
-------------------------S------
---------------------------SQ---
--SSQ-SS-SSSQSQ-----------------
--------------------------------
-----------------------X--S-----
-----SQ---X---Q-------XXX-------
---S-----XX-----------XXX-------
--------XXX-----------XXX-X-----
-------XXXXX------<>-XXX-XX--}--
--{---XXXXXX------[]XXXXXXX--X--
XXXXXXXXXXXXXXXXXXXXXXXXXXXXXXXX
