--------------------------------
--------------------------------
--------------------------------
--------------------SS-SQ-------
--Q-----------------------------
-----S--------------------------
--------------------------------
------------------------SSS-----
-SSQ-------SQS---S--------------
-----------------------------S--
--------------------------------
---------<>--<>-X---<>---XX-----
--{------[]--[]-X---[]---XX-----
XXXXXXXXXXXXXXXXXXXXXXXXXXXXXXXX
