--------------------------------
--------------------------------
--------------------------------
--------------------------------
--------------------------------
--------------------------------
--------------------------------
-------------------------SS-----
--------------------------------
--------------------------------
----------X--X------------------
---------XXX-XXX---------XX--}--
-----{--XXXXXX-XX-------XXX--X--
XXXXXXXXXXXXXXXXXXXXXX--XXXXXXXX
