--------------------------------
--------------------------------
----------------SS--------------
--------------------------------
--------------------------------
--------------------S---SQSQ----
----------------Q---------------
------------Q-------------------
----------------------------S---
------------X-------S-----Q-----
-----------XX--XX---------S-----
-----<>---XXX--XX------------}--
--{--[]--XXXX--XX------XX----X--
XXXXXXXXXXXXX--XX-----XXX----XXX
