--------------------------------
--------------------------------
--------------------------------
-----------------------S-Q------
---------------S----------------
-------------------Q------------
-------------------------Q--SQ--
--------------------------------
----Q--S-------S----------------
--------------------------------
-------------------S-----XX-----
------<>----X-X----------XX--}--
--{---[]----XXX--------XXXX--X--
XXXXXXXXXXXXXXXXXXXXXXXXXXXXXXXX
