--------------------------------
--------------------------------
--------------------------------
-------------------------Q------
--------------------------------
--Q-----------------------------
--------------------------------
---------S-SQ-------------------
--------------------------Q-----
------------------QS------------
--------------------------------
------<>-------X----------}-----
---{--[]-------XX---------X-----
XXXXXXXXXX-----X--------XXXXXXXX
