--------------------------------
--------------------------------
--------------------------------
--------------------------------
-----------------QQQSQ----------
--------------------------Q-----
--------------------------------
--------------------------------
----------------------------Q---
--------------------------------
-----<>------------X---S--------
-----[]--------<>-XXXX-------}--
--{--[]--------[]XXXXX-------X--
XXXXXXXXX----XXXXXXXXXX----XXXXX
