--------------------------------
--------------------------------
--------------------------------
-------------------------QQ-----
--------------SSQ---------------
--------------------------------
---------------------S--Q-Q-----
-----------SQ-------------------
--------S---------Q-------------
-------------------S------------
------<>------X-------S---------
------[]------XX---------X---}--
---{--[]------XXX--------XX--X--
XXXXXXXXXX-----XX--------XXXXXXX
