--------------------------------
--------------------------------
-----------------SSQ------------
--------------------------------
--------------------------------
-----SS-------------------------
--------Q-----------------------
---------------S---S------------
-----------------------------SQ-
----------------XXX-------------
---------<>-----XXXX---<>-------
-----<>--[]-----XXXXX--[]--}----
-----[]--[]--X---XXXX--[]--X----
XXXXXXXXXXXXXX--XXXXXXXXXXXXXXXX
