--------------------------------
--------------------------------
-------------------SQS----------
---------------------------S----
--------------Q-----------------
--------------------------------
----------S---------------------
-------------Q-------------SSQ--
--S----------------Q------------
--SQ--X-------------------------
-----XXX---<>-------------------
------XX---[]-------<>----}-----
--{---XX---[]-------[]----X-----
XXXXXXXXXXXXX-----XXXXXXXXXXXXXX
