--------------------------------
--------------------------------
--------------------------------
--------------------------------
--------------------------------
-------------SQ--Q--------------
-----------S--Q-----------------
--S-----------------------------
--------------------------------
--------XXX-----------XX--------
-------XXXX-----------XXX-------
-------XXX----<>------XXX---}---
--{----XXX----[]-------XXX--X---
XXXXX--XXXXXXXXXXXXXXXXXXXXXXXXX
