--------------------------------
--------------------------------
--------------------------------
--------------------------------
--------------------------------
--------------------------------
----------------S---------------
------SS-S----------------------
--------------S------X----------
---------------------XX---------
---------------------XXX--------
---------------------XXXX---}---
--{------------------XXXXX--X---
XXXXXX---------------XXXXXXXXXXX
