--------------------------------
--------------------------------
--------------------------------
------------SSS-----------------
------------------Q-------------
---------------------------Q----
--------------------------------
------------------SSQ----Q------
-----------------------------S--
--------------------------------
-----<>-------------------------
-----[]----------<>----X----}---
--{--[]----------[]----XX---X---
XXXXXXXXX------XXXXXXXXXXXXXXXXX
