--------------------------------
--------------------------------
--------------------------------
--Q-----------------------------
---------------Q----------------
--------------------SQ--SSS--S--
----Q-------SQS--S--------------
-----------------------------S--
--------------------Q----XX--Q--
---SSSQ-----Q---<>-----XXXX-----
-----------S----[]-----XXXX-----
----------------[]----XXXXX--}--
----------------[]---XXXXXX--X--
XXXXXX----XXXXXXXXXXXXXXXXXXXXXX
