--------------------------------
--------------------------------
--------------------------------
--------------------------------
--------------------------------
-----------------Q---------Q----
-----------SS-------------------
--------------------------------
---------------------X-------SS-
--------------------XXX---------
-----<>-------------XXXX--------
-----[]--<>----------XXXX---<>--
--{--[]--[]----------XXXXX--[]--
XXXXXXXXXXXXXX-XXXXXXXXXXXXXXXXX
