--------------------------------
--------------------------------
------S-------------------------
--------------------------------
------------SS------------------
--------S-----------------------
--------------------------SSQS--
-----------------S--SS----------
--------------------------------
---Q------S--Q--<---------------
-----------------]--SS----------
------<>-----X--[>-----------}--
----{-[]-----X--[]-----------X--
XXXXXXXXXX--XXXXXXXXX------XXXXX
