--------------------------------
--------------------------------
---<>--------------S--Q---------
---[]-----SQQQQ-----------------
---[]-----X------S--------------
-----------------------S--------
--------------------------------
----------SQ--------------------
--Q----------------Q------------
--------------------------------
-----X-X----------------SQS-----
-----XX----<>--<>----X-------<>-
--{--XX----[]--[]---XXX------[]-
XXXXXXXXXXXXXXXXXXXXXXXX-XXXXXXX
