--------------------------------
--------------------------------
----------S---------------------
--------------------------------
--------------------Q-----------
------S-------------------------
--S-----------------------------
--------------------------------
--------------------------------
---------------XX---------------
---------XS----X-------<>-------
-----<>-------XX-------[]----}--
--{--[]------XXX---{---[]----X--
XXXXXXXXXXXXXXXXXXXXXXXXXXXXXXXX
