--------------------------------
--------------------------------
--------------------------------
--------------------------------
--------------------------------
--------------------------------
--------------------------SS----
---------------Q----------------
--------------------------------
----------S---------------------
------------------<>------X-----
------------------[]-----XX--}--
----{--------X----[]----XXX--X--
XXXXXX-------XXXXXXXXX--XXXXXXXX
