--------------------------------
--------------------------------
------S-------------------------
------------------------Q-------
------------S--Q----------------
--------Q-----------------------
----------------------SQ--SSSS--
---------------Q----------------
--------------------------------
--SQQ<XS----Q---<>-------X------
-----[]---------[]--<>---X------
----------------[]--[]--XXX--}--
----{-----------[]--[]-XXXX--X--
XXXXXXXXXXXXXXXXXXXXXXXXXXXXXXXX
