--------------------------------
--------------------------------
--------------------------------
------------------------QSQS----
--------------SSQ---------------
--------------------------------
----------S---------------------
--------------------------------
-----------------SS-------------
--S---<>------------------------
------[>--Q--Q------------------
------[]------------<>----------
--{---[]------------[]----X-----
XXXXXXXXXXX-------XXXXXXXXXXXXXX
