--------------------------------
--------------------------------
--------------------------------
--------------------------------
--------------------------------
-----------------Q--------------
-----------S--------------------
-----Q--------------------------
---------------------X-------S--
--------------Q------XX---------
-----<>--------------XXX--------
-----[]--<>-----------XXX---}---
--{--[]--[]-----------XXXX--X---
XXXXXXXXXXXXX---XXXX--XXXXXXXXXX
