--------------------------------
--------------------------------
--------------------------------
----------S---------------------
--------------------------------
-------------------SQQ----S-----
--------------------------------
------Q------Q-------------S-S--
-----------------SSQSQ----------
--------------------------------
-----X-----<>-------------------
-----XX----[]-------<>---X---}--
--{--XX----[]-------[]--X----X--
XXXXXXX--XXXXXX---XXXXXXX--XXXXX
