--------------------------------
--------------------------------
--------------------------------
------------------------QSQS----
------------SQSSQ---------------
--------------------------------
--------------------------Q-----
-----S--------Q-----------------
-----------------S--------------
------------------Q-------------
------<>------------------------
------[]-------X---------X---}--
---{--[]-------XX-------XXX--X--
XXXXXXXXXXX----X--------XXXXXXXX
