--------------------------------
--------------------------------
--------------------------------
--------------------------------
--------------SSS---------------
--------------------------------
---------S----------------------
-----S-----S--------------------
------------------Q-------------
--------------------------------
------<>--X---------------------
------[]---X--------------}-----
--{---[]--XX--------------X-----
XXXXXXXXXXXX---X-----XXXXXXXXXXX
