--------------------------------
--------------------------------
----------------------------Q---
------------S-------------------
-------------------------S------
--------------------------------
--------------------------------
--------------------X-------S---
-------------------XX----QS-----
--Q---<>----------XXX-----------
------[]---------XXXX-----------
------[]--------XXXXX-----}>----
--{---[]---XX--XXXXXX-----[]----
XXXXXXXXXXXXXXXXXXXXX---XXXXXXXX
