--------------------------------
--------------------------------
-----------------SS-------------
--------------------------------
------------------------S-------
---S----------------------------
----------------------------SQ--
------------------X-------------
-----------------XX-------Q-----
----------------XXX---S---------
-------<>------XXXX-------------
-------[]-----XXXXX----------}--
-------[]----XXXXXXX---------X--
XXXXXXXXXXXXXXXXXXXX---XXXXXXXXX
