--------------------------------
--------------------------------
--------------------------------
--------------------------------
--------------------------------
--------------------------------
-----------S-----S--------------
--------------------------------
-------------X------------------
---Q--------XX-------X----------
-----------XXX-------XX---------
-----------XXX-------XXX-----}--
---{-------XXX-------XXXX----X--
XXXXXX---XXXXXXXXXXXXXXX--XXXXXX
