--------------------------------
--------------------------------
--------------------------------
--------------------------------
--------------------------------
------------------SS-QQ---SQSS--
--------------------------------
--S---------QSS-----------------
------------------------Q-------
------------------S--S----------
------------Q-------------------
---------------X----------}--}--
-----{--------XX----------X--X--
XXXXXXX-------------XXXXXXXXXXXX
