--------------------------------
--------------------------------
--------------------------------
-------SS-S-SQ------S-----------
--------------------------SQ----
-----------------Q--Q-----------
---SQ--Q----S-------------------
-----Q-------------------SSQ----
---------------------X----------
--S-------X---------XX-------<>-
----------XXX-X-----XXX------[]-
-----XX----XXX----XX-XX------[]-
--{--XX---XXXXX--XXX-XXX-----[]-
XXXXXXX--XXXS>-XX----XX--X-XXXXX
