--------------------------------
--------------------------------
---------------------------SSQ--
----------S-S-------S-----------
-------------Q------------------
--------------------------------
--------------------XX-------Q--
-------------------XX----Q-S----
----------------S--XXX----------
-------<>---------XXXX----------
-------[]--------XXXX---Q-------
--X----[]--X----XXXXX------}----
-X{----[]-XX---XXXXXX------X----
XX---XXXXXXXXXXXXXXXXXXXXXXXXXXX
