--------------------------------
--------------------------------
--------------------------------
--------------------------------
--------------------------------
--------------------------------
--------------------------------
--------------------------------
--------------------------------
-----<>-------------------------
-----[]--------X----------------
-----[]-------XX------<>-----}--
--{--[]-----XXXX------[]-----X--
XXXXXXXXX--XXXXX---XXXXXXXXXXXXX
