--------------------------------
--------------------------------
--------------------------------
--------------------------------
--------------------------------
------------------------Q-------
-------------S-SS--S------------
--------------------------------
------------XX------------------
-----------XXX--<S--------------
----------XXXX---------X--------
---------XXXXX---------XX----}--
--{-----XXXXXX--------XXXX---X--
XXXXXXXXXXXXXXXXXXXXXXXX---XXXXX
