--------------------------------
--------------------------------
--------------------------------
-------SQ---------Q---S---------
--------------------------S-----
--------------------------------
---Q-S------S----Q--------------
------------------Q-------------
-------------------------Q---S--
--------------------------------
-----<>-------------XX----------
-----[]----X-------XXX-----}----
--{--[]----XX-----XXXX-----X----
XXXXXXXXX--XXX--XXXXXXX----XXXXX
