--------------------------------
--------------------------------
--------------------------------
----------S---------S-----------
-------------------------S--Q---
--------------------------------
--------------------------------
---------------XX--S---Q----SS--
--------------XXX---------------
------------XXXX----------------
------------XXXX--------SS---<>-
-----------XXXXX--[XX-----}->[]-
---{---X--XXXXXX--[XX-----X---]-
XXXXXXXXXXXXXXXXXXXXX---XXXXXXXX
