--------------------------------
--------------------------------
--------------------------------
--------------------------------
--------------------------------
-----------------SQ-------------
--------------------------------
----S--------SS-----------Q-----
-----------------------------Q--
-------------------Q------------
--------------XX----------------
---------<>--XXX----------}--}--
--{------[]-XXXX----------X-----
XXXX---XXXXXXXXXXXXX--XXXXXXXXXX
