--------------------------------
--------------------------------
--------------------------------
--------------------------------
-------------Q------------------
--------------------------------
--------------------------------
----------------X---------S-----
--------------XXX---------------
---SQ--------XXXX---------------
-------<>---XXXXX---------------
-------[]---XXXXXXX----------}--
-------[]--XXXXXXXX--XXX----XX--
XXXXXXXXXXXXXXXXXXXXXXXXXXXXXXXX
