--------------------------------
--------------------------------
--------------------------------
-----------------S-----------S--
-----------SQ-------------------
-----------------------S--------
---------S----------Q-----------
--------------------------------
----------------------------Q---
----------------QS------X-------
---------XX--Q----------X-------
-----<]--XX------]------XX---}--
-----[]--XX---------XX--XX---X--
XXXXXXXXXXX-----XXXXXX-----XXXXX
