--------------------------------
--------------------------------
--------------------------------
--------------------------------
--------------------------------
-----------------------SQ-------
--------------------------------
--------------------------------
----S-----------------------S---
----------------<>--------------
----------------[]-----X--------
----------------[]-----XXX---}--
--{--XX---------[]-----XXX---X--
XXXXXXXX---XXXXXXXXXXXXXX-XXXXXX
