--------------------------------
--------------------------------
--------------------------------
-------SQ---------Q-------------
--------------------------------
--------------------------------
-----S-----SS---SQ-S------------
--------------------------------
----S-------------------SQS-----
--------------------------------
--------------------X-----------
-----<>----X--------XX----}-----
--{--[]----XX------XXX----X-----
XXXXXXXXX--XXX--XXXXXX--XXXXXXXX
