--------------------------------
--------------------------------
--------------------------------
--------------------------------
-----------------S--------------
--------------------------------
--------------------------------
--------------------------------
--------------------------------
--------------------------------
--------------------X-----------
-----<>--------<>-XXXX-------}--
-----[]--------[]XXXXX-------X--
XXXXXXXXXXXXXXXXXXXXXX-----XXXXX
