--------------------------------
--------------------------------
--------------------------------
--------------------------------
--------------------------------
--------------------------------
--------------------------------
--------------------------------
--------------S---Q-------------
--------------------------------
--------------------------------
------<>-X-----<>---------}-----
--{---[]XX-----[]---------X-----
XXXXXXXXXXXXXXXXXXX--XXXXXXXXXXX
