--------------------------------
--------------------------------
--------------------------------
--------------------------------
--------------------------------
--------------------------------
--------------------------------
-------------------S------------
--------------------------------
----------X---------------------
---------XXX--------------------
-----<>-XXXX------<>--<>-----}--
--{--[]-XXXX------[]--[]-----X--
XXXXXXXXXXXXXXXXXXXXXXXXXXXXXXXX
