--------------------------------
--------------------------------
--------------------------------
--------------------------------
--------------------------------
--------------------------------
--------------------------------
--------------------------------
--------QSQ---------------------
--------------------------------
--------------------------------
------<>--------<>----<>----}---
--{---[]XX------[]----[]----X---
XXXXXXXXXXXXXXXXXXXXXXXXXXXXXXXX
