--------------------------------
--------------------------------
--------------------------------
----------S---------------------
--------------Q--S--------------
--------------------------------
--------------------------------
-----------Q--------------------
-------------------Q------------
--------------------------------
--------------------------------
------<>---<>--<>---------}--<>-
--{---[]---[]--[]---XX----X--[]-
XXXXXXXXXXXXXXXXXXXXXXXXXXXXXXXX
