--------------------------------
--------------------------------
--------------------------------
--------------------------------
--------------------------------
------------------SS------------
--------------------------------
--------------------------------
--------------S------Q----------
--------------------------------
---------------------XX---------
-----<>----<>--<>----XXX--}-----
--{--[]----[]--[]---XXXX--X-----
XXXXXXXXXXXXXXXXXXXXXXXXXXXXXXXX
