--------------------------------
--------------------------------
--------------------------------
--------------------------------
---------------Q----------------
--------------------------------
-----------------S--------------
---------------Q----------------
--------------------------X-----
---SQSQS--S--------------XX-----
-------------------------XX-----
----------XX----<>------XXX-----
---{------XX----[]-----XXXX-----
XXXXXXX---XXXXXXXXXXXXXXXXXXXXXX
