--------------------------------
--------------------------------
---<S---------------------------
---[S--------SQQS-----------Q---
----]---------------------------
--------------------S-SSQ--Q----
----------------------------S---
--------------------------------
---SQ---------------------------
--------S-----------------------
-----------<>-------------Q-----
-----------[]-------<>-X----<>--
--{--------[]-------[]XXX---[]--
XXXXX--XXXXXXXXXXXXXXXXX--XXXXXX
