--------------------------------
--------------------------------
--------------------------------
--------------------------------
-----------------QQ--Q----------
----SS-----------------Q--Q-----
------------Q-------------------
---------------S--S-------------
-----------------------------S--
--------------------XX----------
--Q--<>------------XXX----------
-----[]-----X--<>-XXXXX----}----
-----[]----XX--[]XXXXXXX---X----
XXXXXXXXXXXXXXXXXXXXXXXXXXXXXXXX
