--------------------------------
--------------------------------
--------------------S-----------
--------------------------Q-----
--------------SQ----------------
--S-----------------------------
-----------------S--------------
--------------------------------
---------------------S----------
---S----------------------------
----------Q--Q------------X-----
------<>--------<>--<>---XX-----
---{--[]--------[]--[]--XXX-----
XXXXXXXXXXX---XX-XXXXXXXXXXXXXXX
