--------------------------------
--------------------------------
----------S---------------Q--Q--
---------------S----------------
--------------------------------
--------------------------------
--SS----------Q-----------------
----------------S---------------
------Q------------S------------
--------------------------------
-----------------------<>-------
-----<>----XXXX---<>---[]----}--
--{--[]----XXXXX--[]---[]----X--
XXXXXXXXXXXXXXXXXXXXXXXXXXXXXXXX
