--------------------------------
--------------------------------
--------------------------------
-------------S------------------
--------------------------------
-----------------Q--------------
-------------S--S---------------
--------------------------------
---------------------X----------
---------------------XX---------
---------------------XXX--------
-----<>----<>--<>----XXXX---}---
--{--[]----[]--[]-----XXXX--X---
XXXXXXXXX-XXXXXXXXXXXXXXXXXXXXXX
