--------------------------------
--------------------------------
--------------------------------
--------------------------------
--------------------Q-----------
-----------------Q--------------
--------------------------------
--------------------------------
--------------------------------
--------------Q-----------------
---------X----------------------
-----<>-XX--------<>---<>----}--
--{--[]XXX--------[]---[]----X--
XXXXXXXXXXXXX---XXXXXXXXXXXXXXXX
