--------------------------------
--------------------------------
--------------------------------
--------------------------------
--------------------------------
-------S-S----------------------
--------------------------------
-----------------S--SSSQQS------
---S-SSSQSSSQS------------------
--------------------------------
-------------------------S------
-----<>-XX-------<>----------}--
--{--[]XXX-------[]----------X--
XXXXXXXXXX----XXXXXXXXX-XXXXXXXX
