--------------------------------
--------------------------------
--------------------------------
--------------------------------
-------------S------------------
-------SS-----------------------
--------------------------------
-----------------S--------------
-----QSQ--SQ-S------------------
-------------Q------------------
-------------------------Q------
---------XX------<>---------}---
--{-{---XXX------[]---------X---
XXXXXXXXXXXXXXXXXXXXXXX---XXXXXX
