--------------------------------
--------------------------------
-------------------SQS----------
--------------------------------
------------SSQ-----------------
--------S-----------------------
--------------------------------
--------------------------------
--S--------Q--------------------
---Q----------------------------
------<>------------------------
------[]---<>-------<>----}-----
--{---[]---[]---[---[]----X-----
XXXXXXXXXXXXXXXXXXXXXXXXXXXXXXXX
