--------------------------------
--------------------------------
------------------------Q-------
---------------S----------------
--------------------------------
--------------------------------
---S-------------S--S-----------
--------------------------------
----------XX--------------------
--------XXXX--------------------
-------XXXXX-----------XX-------
-------XX-XX--<>--<>---XXX---}--
--{----XX-XXX-[]--[]---XXXX--X--
XXXXX--XXXXXXXXXXXXXXXXXXXXXXXXX
