--------------------------------
--------------------------------
------------------------Q-Q-----
--------------------------------
--------------------------------
--------------------------------
---S-------SS-SS----------------
--------------------------------
------Q------------S------------
----------XX--------------------
---------XXX-----------<>-------
-----<>-XXXX------<>---<>---}---
--{--[]XXXXX------[]---[]---X---
XXXXXXXXXXXXXXXXXXXXXXXXXXXXXXXX
