--------------------------------
--------------------------------
--------------------------------
--------------------------------
--------------------------------
--------------------------------
--------------------------------
--------------------------------
--------------------------------
---------------------X----------
--------------------XXX---------
-----<>--<>--------XXXXX-----}--
--{--[]--[]-------XXXXXXX----X--
XXXXXXXXXXXXXXXXXXXXXXXXXXXXXXXX
