--------------------------------
--------------------------------
--------------------------------
--------------------------------
----------------SQ--------------
-------------------Q------------
--------------------------------
--------------------------------
-----------------------Q--------
--------------------------------
--------------------------------
-----<>--------<>-X--X-------}--
-----[]--------[]XXX-XX------X--
XXXXXXXXXXXXXXXXXXX--XX-XXXXXXXX
