--------------------------------
--------------------------------
--------------------------------
--------------------------------
--------------------------------
--------------------------------
--------------------------------
------------XX------------------
-----------XXX-----Q--------S---
----------XXXX------------------
---------XXXXX---------S--------
--------XXXXXX--------------}---
---{----XXXXXXX-------X-----X---
XXXXXXXXXXXXXXXXXXXXXXXXXXXXXXXX
