--------------------------------
--------------------------------
--------------------------------
---------------S----------------
--------------------------------
--------------------------------
--------------------------------
--------------S-----------------
------------------S-------------
---Q---S------------------------
-----------X--------------------
----------XX--->--<>--X------}--
---{-----XXX--[]--[]--XX-----X--
XXXXXXXXXXXXXXXXXXXXXXXXXXXXXXXX
