--------------------------------
--------------------------------
--------------------------------
----------------S---------------
--------------------------------
--------------------------------
--------------------------------
--------------------------------
--------------------------------
--------------------------------
---------X----->----X-----------
-----<>-XXX---<>---XXX-------}--
--{--[]XXXX---[]---XXX----X--X--
XXXXXXXXXXXXXXXXXXXXXX--XXXXXXXX
