--------------------------------
--------------------------------
--------------------------------
--------------------------------
-----------------------X--------
--------------------S-----------
--------------------------------
----------------S---------SQ----
----------------------SS--------
--------------------------------
--------------------------------
------------->------<>---XX--}--
--{-------------X---[]---XX--X--
XXXXXX--XXXXX--XXXX-XXX-XXXXXXXX
