--------------------------------
--------------------------------
--------------------------------
--------------------------------
--------------------------------
--------------------------------
--------------------------------
------------X-------------------
-----------XX-------------------
----------XXX----------X--------
---------XXXX---------XX--------
--------XXXXX-----<>-XXX-----}--
---{---XXXXXX--X--[]XXXX-----X--
XXXXXXXXXXXXXXXXXXXXXXXXXXXXXXXX
