--------------------------------
--------------------------------
--------------------------------
--------------------------------
--------------------------------
--------------------------------
--------------------------------
------------------S--------S----
------------------------X-------
-----------------------XX-------
--------X-------------XXX-------
------XXX----<>------XXXX-------
--{---XXX----[]-----XXXXX--X----
XXXXXXXXXXXXXXXXXXXXXXXXXXXXXXXX
