--------------------------------
--------------------------------
--------------------------------
---------------S-SQ-------------
-----------Q-----------------QQ-
--------------------------------
---------------------Q----------
--S-----------S-----------------
--------------------------------
------SS---------------X--------
----------------------XX--------
----------<>--[]-----XXXX----}--
--{{------[]--[]----XXXXXX---X--
XXXXX--XXXXXXXXXXXXXXXXXXXXXXXXX
