--------------------------------
--------------------------------
-------------------------SQ-----
--------------------------------
-----S--------------------------
--------------------S--SQ-------
----------------SQ--------------
--------------------------------
--SS----------------S----S-S----
----S------X------<>--SQ--------
----------XX------[]------------
----------XX------[]---------}--
--{-----X-XX------[]---------X--
XXXXX-----XX---XXXXXXXX--XXXXXXX
