--------------------------------
---S----------------------------
---Q-------SS-----S-------------
--------------------------------
--------------------------QS----
-----------------------S--------
----------------S---------------
-------------S-S---------Q------
---------------------------S----
---SQS------------Q---QQ--------
--------------------------X-----
-----------------------X--}X----
--{---------X---------XX--XX----
X-------------------XXXXX-XXXXXX
