--------------------------------
--------------------------------
-----------------------SS-------
-------------------------Q------
--------------------------------
--------------------------------
----SQSS------Q--------------Q--
-----------Q----SQ---Q-------Q--
-------------------------XX-----
-------------------------XX-----
-----S---------<-<>-----XXX-----
-----------S----][-----XXXX--}--
--{------------X------XXXXX--X--
XXXXXXX-------XXXXXXXXXXXXXXXXXX
