--------------------------------
--------------------------------
--------------------------------
-----------------S-Q------------
--------------------------------
--------------------------------
--------------------------------
--------------------------------
--------------------------------
--------------------------------
---------XX---------XX----------
---------XX---<>----XX-------}--
--{-----XXXX--[]----XX-------X--
XXXXXXXXXXXXXXXXXXXXXXXXXXXXXXXX
