--------------------------------
--------------------------------
--------------------------------
-----Q--------------------------
--------------------------------
--------------------------------
--------------------------------
--------------------------------
-------------------------X------
--Q---------------------XX------
-----------------------XXX------
---------------XX-----XXXX---}--
--{------------XX---XXXXXXX--X--
XXXXXXXXXXXXXXXXXXXXXXXXXXXXXXXX
