--------------------------------
--------------------------------
--------------------------------
--------------------------------
----------------Q---------------
--------------------------------
--------------------------------
----------------------------Q---
------------------------XX------
------------------------XX------
-----<]---------------XXXX------
-----[]--------<>----XXXXX--}---
--{--[]--------[]--X-XXXXX--X---
XXXXXXXXXXXXXXXXXXXXXXXXXXXXXXXX
