--------------------------------
--------------------------------
--------------------------------
--------------------------------
---SQ---------------------------
--------SQ-------------------S--
-------------X------------------
------------XX------------------
----S------XXX-----Q--------S---
----------XXXX------------------
---------XXXXX----Q----SS-------
--------XXXXXX--------------}---
----{--XXXXXXX--------------X---
XXXXXXXXXXXXXXXXXXXX-XXXXXXXXXXX
