--------------------------------
--------------------------------
--------------------------------
---------------S-S--------------
---------------------------SSSQ-
--------------------------------
---------------------Q----------
--------------S--SS-----X--S----
-----------------------XX-------
----------------------XXX-------
----------------------XXX-------
----------<>--<>-----XXXXX---}--
--{-------[]--[]----XXXXXXX--X--
XXXXX---XXXXXXXXXXXXXXXXXXXXXXXX
