--------------------------------
--------------------------------
--------------------------------
-----------------SSQ------------
--------------------------------
--------------------------------
--------------------------------
--------------------------------
--------------------------------
--------------------------------
---------XX---------XX----------
--------XXX---<>----XX-------}--
--{-----XXX---[]---XXX-------X--
XXXXXXXXXXXXXXXXXXXXXXXXXXXXXXXX
