--------------------------------
--------------------------------
--------------------------------
----------------S---------------
--------------------------------
-----------------------S---Q----
--------------------------------
------------------Q-------------
---SQ------SSQ------------------
--------------------------------
------------------------SQS-----
-----<>----<>----<>-X--------}--
--{--[]----[]----[]XXX-------X--
XXXXXXXXXXXXXXXXXXXXXXXX---XXXXX
