--------------------------------
--------------------------------
--------------------------------
--------------------------------
--------------------------------
-----------------SQS------------
--------------------------------
--------------------------------
---------------------X----------
--------------------XXX---------
--------------------XXXX--------
-----<>--<>--------XXXXXX----}--
--{--[]--[]--X----XXXXXXXX---X--
XXXXXXXXXXXXXXXXXXXXXXXXXXXXXXXX
