--------------------------------
--------------------------------
--------------------------------
--------------------------------
--------------------------------
-------------S------------------
--------------------------------
--------------------------------
--------------------------------
--------------------------------
--------------------------------
--------------<>--<>-----X---}--
--{-----------[]--[]----XXX--X--
XXXXXX--XXXXXXXXXXXXXXXXXXXXXXXX
