--------------------------------
--------------------------------
--------------------------------
----------------S---------------
--------------------------------
--------------------------------
--------------------------------
--------------------------------
--------------------S-----------
--------------------------------
------------------------X-------
------->---<>---<>--<>-XX----}--
--{--------[]---[]--[]XXX----X--
XXXXX--XXXXXXXXXXXXXXXXXXXXXXXXX
