--------------------------------
--------------------------------
--------------------------------
--------------------------------
--------------------------------
--------------------------------
--------------------------------
--------------------------------
--------------------S-----------
--------------------------------
--------------------------------
-----<>---------<>-----------}--
--{--[]---------[]--X--------X--
XXXXXXXXXXXXXXXXXXXXX------XXXXX
