--------------------------------
--------------------------------
--------------------------------
--------------------------------
--------------S-----------------
--S-----------------------------
--------------------------------
--S--S--------Q-----------------
---------------------S----------
-----------------SQQ------------
----------X---------------X-----
------<>--------------<>--}-----
---{--[]--X----X------[]--X-----
XXXXXXXXXXXX--XX----XXXXXXXXXXXX
