--------------------------------
--------------------------------
-----------------------------Q--
-------------SS-----------------
--------------------------------
--------------------SQ--SS-S----
------------SQSS----------------
------Q-------------------------
--------------------Q-----------
--------------------------------
--------Q--<>----------XX-------
-----------[]---------XXX---<>--
--{--------[]---------XXXX--[]--
XXXXX----XXXXXXXXXXXXXXXXXXXXXXX
