--------------------------------
--------------------------------
--------------------------------
----S-----S-----S---------------
--------------------------------
--------------------------------
--------------------------------
-------------Q-------------S-S--
-------------------QS-Q---------
--S-----------------------------
-----------<>-------------------
------XX---[]-------<>-X-----}--
--{--XXX---[]-------[]-XX----X--
XXXXXXXXXXXXXXXXXXXXXXXXX--XXXXX
