--------------------------------
--------------------------------
--------------------------------
--------------------------------
--------------------------------
-----------------Q--------------
--------------------------------
--------------------------------
--------------------------------
--------------------------------
--------------------------------
-----<>-X---------<>--<>-----}--
--{--[]XX---------[]--[]-----X--
XXXXXXXXX-------XXXXXXXXXXXXXXXX
