--------------------------------
--------------------------------
------S--Q----------------------
--------------------------------
--------------------------------
--------S-----------------------
--------------------------------
--------------------------------
----------SQ--------------------
----------S--Q------------------
--------------------S>----------
----------------<>--[]------}---
---{------------[]--[-------X---
XXXXXXX------XXXXXXXXXXXXXXXXXXX
