--------------------------------
--------------------------------
--------------------------------
--------------------------------
--------------------------------
--------------------------------
--------------SSSS--------------
--------------------------------
--------------------------------
-----S-----------------XXX------
-----------------------XXX------
------------------<>--XXXX--}---
--{---------------[]--XXXX--X---
XXXXX---------XXXXXXXXXXXXXXXXXX
