--------------------------------
--------------------------------
--------------------------------
--------------------------------
--------------------------------
--------------------------------
--------------------------------
----------------S---------------
----SSSSS-S---------------------
--------------------------------
--------------------------------
-----<>------X---<>----<>----}--
--{--[]------X---[]----[]----X--
XXXXXXXXX----XXXXXXXXXXXXXXXXXXX
