--------------------------------
--------------------------------
--------------------------------
-------------SSQ----------------
--------------------------------
--------------------S-SSSS-S----
--------------------------------
--------------------------------
---SQQ--------------Q-----------
--------------------------------
--------------------------------
-----------<>----<>----XX----}--
--{--------[]----[]---XXX----X--
XXXXX---XXXXXXXXXXXXXXXXX-XXXXXX
