--------------------------------
--------------------------------
--------------------------------
--------------------------------
--------------------------------
------------------SS------------
--------------------------------
-----SS-------------------SSS---
--------------S-----------------
----------------------XX--------
----------------------XXX-------
---------<>---<>-X---XXXXX---}--
--{------[]---[]XX---XXXXXX--X--
XXXXXXXXXXXXXXXXXX---XXXXXXXXXXX
