--------------------------------
--------------------------------
----S---------------------------
----S-----S-----S---------------
-------------SQ-----------------
--------------------Q--S--S-----
--------------------------------
--------------------------------
--Q----------------QSQQ---------
--------------------------------
--------------------------S-----
------XX---<>--<>---<>-X-----}--
--{---XX---[]--[]---[]-------X--
XXXXX-XXXXXXXXXXXXXXXXXX---XXXXX
