--------------------------------
--------------------------------
--------------------------------
--------------------------------
----------------S---------------
----------------S-SSQ-----------
--------------------------------
---------S-----------------SS---
------------------Q-------------
-----------------------SQ-------
--------------------------------
-----<>--------<>----X-------}--
-----[]-----{--[]XX--XX------X--
XXXXXXXXXXXXXXXXXXX--XX----XXXXX
META {"type": "geom", "shape": "path", "group": "path", "data": [[12, 12, 12, 13], [12, 13, 10, 15], [10, 15, 10, 16], [10, 16, 10, 17], [10, 17, 11, 18], [11, 18, 9, 20], [9, 20, 10, 21], [10, 21, 8, 23], [8, 23, 8, 24], [8, 24, 7, 25], [7, 25, 8, 26], [8, 26, 9, 27], [9, 27, 10, 28], [10, 28, 11, 29]]}
