--------------------------------
--------------------------------
--------------------------------
--------------------------------
--------------------------------
---------SSS--------------------
--------------------------------
--------------------SSQS--------
---S-S--SSQSSQ------------------
--------------------------------
------------------------SQ------
------X----<>--<>---<>-------}--
--{--XX----[]--[]---[]-------X--
XXXXXXX--XXXXXXXXXXXXXXX---XXXXX
