--------------------------------
--------------------------------
--------------------------------
---------------Q----------------
--------------------------------
-------------------------S------
----------------------S---------
--------------------------------
-----Q-----Q--------------------
--------S-------<>--------------
----------------[]--------------
----------------[]-----XX---}---
----{-----------[]----XXX---X---
XXXXXX-----XXXXXXXXXXXXXXXXXXXXX
