--------------------------------
--------------------------------
--------------------------------
--------------------------------
------------------S-------------
----------S---------------------
--------------------------------
-----------------------SSS------
--------SSQ----S----------------
--------------------------------
------------------------S-------
------<>---<>--<>---------}-----
--{---[]---[]--[]---------X-----
XXXXXXXXXXXXXXXXXXXXXXXXXXXXXXXX
