--------------------------------
--------------------------------
--------------------------------
--------------------------------
--------------------------------
--------------------------------
--------------------------------
-----------------------S--------
---S--SSSSQSSQ--------------Q---
--------------------------------
------------------------SS------
-----<>--------<>--XX--------}--
--{--[]--------[]--XX--------X--
XXXXXXXXXXXXXXXXXXXXX------XXXXX
