--------------------------------
--------------------------------
--------------------------------
--------------------------------
------------SQSQ----------------
--------------------------------
--------------------------Q-----
---Q----------------------------
-------S------------------------
----------S-XX------------------
------------XX------------------
------<>--XXXX--<>-------X---}--
---{--[]-XXXXX--[]------XXX--X--
XXXXXXXXXXXXXXXXXXXXX---XXXXXXXX
