--------------------------------
--------------------------------
--------------------S-----------
------------------------Q--S----
------------SQSQ----------------
--------------------------------
--------------------------------
--------------Q-----------------
--------------------------------
---Q------S---------------------
-------------Q------------X-----
------<>--------<>--<>---XX-----
---{--[]--------[]--[]--XXX-----
XXXXXXXXXXX---XXXXXXXXXXXXXXXXXX
