--------------------------------
--------------------------------
--------------------------------
--------------------------------
-------------S-----Q------------
-------S-SS---------------------
--------------------------------
--------------------SSQQSS------
---S--SQSSSSQS--------------Q---
--------------------------------
-----------------------QSS------
-----------<>----<>-X--------<>-
-----------[]----[]XX--------[]-
X-XXXXXXXXXXXXXXXXXXX------XXXXX
