--------------------------------
--------------------------------
--------------------------------
--------------------------------
--------------------------------
--------------------------------
--------------------------------
--------------------------------
------SQ------------S-----------
--------------------------------
--------------------------------
---------<>-----<>-----X-----}--
--{------[]-----[]--X--X-----X--
XXXXX--XXXXXXXXXXXXXXX-XX--XXXXX
