--------------------------------
--------------------------------
--------------------------------
--------------------------------
--------------------------------
------------------SS------------
-----S--------------------------
--------------------------SS----
--------------S-----------------
--------------------------------
--------------------------------
-----<>-------<>-X----<>--}--}--
--{--[]-------[]XX----[]--X--X--
XXXXXXXXXXXXXXXXXX--XXXXXXXXXXXX
