--------------------------------
--------------------------------
--------------------------------
--------------------------------
--------------------------------
--------------------------------
--------------------------------
--------------------------------
--------QS----SS----------------
--------------------------------
--------------------------------
------<>--------<>----<>--}-----
---{--[]--------[]----[]--X-----
XXXXXXXXXXX--XXXXXXXXXXXXXXXXXXX
