--------------------------------
--------------------------------
--------------------------------
--------------------------------
--------------------------------
------------S-------------------
--------------------------------
---Q-----------------SS---------
-------S-------S----------S-----
------------SQ------------------
------------X-------------------
------<>-X------<>-----------}--
---{--[]XX---X--[]-----------X--
XXXXXXXXXXX-XXXXXXXX-----XXXXXXX
