--------------------------------
--------------------------------
--------------------------------
-------------------------SQ-----
--------------S-----------------
--S-----------------------------
--------------------------------
--S--------S--Q-----------------
---------------------S----------
-----------------SQQ------------
-------------Q------------X-----
------<>-------X------<>-XX-----
---{--[]-------X------[]XXX-----
XXXXXXXXXX-----X----XXXXXXXXXXXX
