--------------------------------
--------------------------------
--------------------------------
--------------------------------
--------------------------------
--------------------------------
--------------------------------
---------SQS--------------------
--------------S-----------------
--------------------------------
----------X-----------<>--------
------<>-XXX----------[]--}-----
---{--[]XXXX----------[]--X-----
XXXXXXXXXXXX--------XXXXXXXXXXXX
