--------------------------------
--------------------------------
--------------------------------
----S-----------S-----------Q---
-------------S------------------
-------SSSSS--------------------
--------------------------SQ----
--------------------SSQ---------
---S------SSSS------------------
--------------------------------
--------------------<>--SQ------
------X----<>-------[]-------<>-
--{--XXX---[]-------[]-------[]-
XXXXXXXXXXXXXXXXXXXXXXXX---XXXXX
