--------------------------------
--------------------------------
--------------------------------
--------------------------------
--------------------------------
--------------------------------
--------------------------------
--------------------------------
--------------S-----------------
--------------------------------
-----------------------XX-------
----------X---<><>-----XXX---}--
--{-------X---[][]-----XXXX--X--
XXXXX----XXXXXXXXXXX---XXXXXXXXX
