--------------------------------
--------------------------------
--------------------------------
--------------------------------
--------------------------------
--------------------------------
--------------------------------
--------------------------------
--------------------------------
--------------------------------
-----------X--------------------
----------XX----<>-----<>---}---
---{------XX----[]-----[]---X---
XXXXXXXXX-XXXXXXXXXXXXXXXXXXXXXX
