--------------------------------
--------------------------------
--------------------------------
-------------Q------------------
--------------------------------
-----------------SQ-------------
--------------------------------
--------------------------------
---------------------X----------
---------------------XX---------
---------------------XXX--------
-----<>--------<>----XXXX----}--
--{--[]--------[]----XXXXX---X--
XXXXXXXXX----XXXXXX--XXXXXXXXXXX
