--------------------------------
--------------------------------
---Q----------------------------
----------S---------------------
-----------------SQQSQ----------
--------------------------Q-----
--------------------------------
--------------------------------
---SQ-------S---------------Q---
--------------------------------
--------------------------------
-----------<>--<>--XX--------<>-
-----{-----[]--[]--XXX-------[]-
X-XXXXXXXXXXXXXXXXXXXXXX---XXXXX
