--------------------------------
--------------------------------
--------------------------------
--------------------------------
--------------------------------
-----------------Q----S------S--
-----------SSQSS----------------
--------------------------------
----------------------X-X-------
----------------------XXX-------
----------------------XXX-------
--------------<>--<>--XXXX---}--
--{-----------[]--[]--XXXX---X--
XXXXX------XXXXXXXXXXXXXXXXXXXXX
