--------------------------------
--------------------------------
--------------------------------
--------------------------------
-------------------Q------------
--------------------------------
--------------------------------
--------------------SQSQS-------
---S-SSSSSQSQS--------------Q---
--------------------------------
-----------------------Q--------
-----<>-X----------XX--------}--
-----[]XX----------XX-----------
XXXXXXXXX-----XXXXXXX------XXXXX
