--------------------------------
--------------------------------
----------S-------------Q-------
---------S----------------------
--------------------Q-----------
----------------------------Q---
--SS----------------------------
---------XX---------------------
---------XXX---X----------------
-------XXXX----XX---------------
-------XXXX----XX------<>-------
-------XXX----XXX-<>---[]----}--
--{----XXX---XXXX-[]---[]----X--
XXXXX--XXXXXXXXXXXXXXXXXXXXXXXXX
