--------------------------------
--------------------------------
--------------------------------
--------------------------------
--------------------------------
--------------------------------
--------------Q-----------------
----------------S--------Q------
-----SQ------------S------------
--------------------------------
--------------------------------
-----<>-X---------<>---<>---}---
--{--[]XXX--------[]---[]---X---
XXXXXXXXXX-X---XXXXXXXXXXXXXXXXX
