--------------------------------
--------------------------------
--------------------------------
--------------------------------
-----------------S--------------
--------------------------------
---------------------S----------
--------------------------------
--------S------------------S----
--------------------------------
----------------------QS--------
-----<>--------<>------------}--
--{--[]-X------[]------------X--
XXXXXXXXX----XXXXXX------XXXXXXX
