--------------------------------
--------------------------------
--------------------------------
--------------------------------
--------------------------------
---------------------S----------
--------------------------------
-----------XXXX-----------------
-----------XXX---------S--Q-----
--S-------XXXXX-----------------
---------XXXXXXX----<>----------
-----<>-XXXXXXXXX---[]-----}----
--{--[]XXXXXXXXXXX--[]-----X----
XXXXXXXXXXXXXXXXXXXXXXXXXXXXXXXX
