--------------------------------
--------------------------------
--------------------------------
--------------------------------
--------------------------------
--------------------------------
--------------------------------
--------Q-----------------------
------------------S-------------
---------X----------------------
----------X--------------X------
--------XXXX----<>------XX---}--
--{--{--XXXXX---[]-----XXX---X--
XXXXXXXXXXXXXXXXXXXXXXXXXXXXXXXX
