--------------------------------
--------------------------------
----S---------------------------
--------------------------------
--------------------------------
---------------------------SQ---
------Q--SQS--------------------
--------------------------------
---------------------S-------S--
-----Q-------------------S------
-------SS--S--------------------
--------------------<>-X-----}--
----{---------------[]XX-----X--
XXXXXXX----------XXXXXXX---XXX-X
