--------------------------------
--------------------------------
---------------------Q----------
-------------------------SS-----
-------S------------------------
--------------------------------
----------------Q---SQ----------
--------QS----------------------
-------------------S------------
--------------Q-----------X-----
-------------------------XX-----
------<>---X-----<>--<>-XXX--}--
--{---[]---X-----[]--[]XXXX--X--
XXXXXXXXXXXXX--XXXXXXXXXXXXXXXXX
