--------------------------------
--------------------------------
--------------------------------
--------------------------------
--------------------------------
--------------------------------
--------------------------------
--------------S-----------------
-----------------------SQ-------
--------------------------------
--------X---------------X-------
--------<>-----<>-------XX---}--
----{---[]XX---[]-------XXX--X--
XXXXXXXXXXXXXXXXXX---XX-XXXXXXXX
