--------------------------------
--------------------------------
----------------------------SS--
---S--S-------------------------
-------------SSQSQS------S------
-----------------------------Q--
--------------------------------
---------Q----------------------
--------------------------------
--------------------------------
-------------------------X------
-----------<>--<>---}---XX---}--
---{-------[]--[]---X--XXX---X--
XXXXXXXXXXXXXXXXXXXXXXXXXXXXXXXX
