--------------------------------
--------------------------------
--------------------------------
--------------------------------
--------------------------------
--------------------------------
--------------------------------
--------------------------------
-------------------SS-----------
--------------------------X-----
-------------------------XX-----
-----<>----<>---<>---<>-XXX--}--
--{--[]----[]---[]---[]XXXX--X--
XXXXXXXXXXXXXXXXXXXXXXXXXXXXXXXX
