--------------------------------
--------------------------------
--------------------------------
--------------------------------
-----------S--------------------
--------------------------SSSS--
--------------------------------
---------------------S----------
-----------------------------S--
----QS--------------------------
--------Q------S----------------
--------------X----<>-----}-----
---{----------X----[]-----------
XXXXXX---X---XX--XXXXXXXXXXXXXXX
