--------------------------------
--------------------------------
----S---------------------------
-----------Q--------------------
-----------------------------Q--
--------------------------------
-----------------------------S--
-----------------------X--------
---------------------XXX---S----
---Q----------------XXXX--------
-----------X-------XXXXX--------
--------<>XX-------XXXXXX-}-----
----{----]XXX-----XXXXXXX-X-----
XXXXXXXXXXXXXXXXX-XXXXXXXXXXXXXX
