--------------------------------
--------------------------------
--------------------------------
--------------SS----------------
---SS-S--------------------S----
--------------------------------
--------------------------------
----SSS-------------------------
--------------------------------
--------------------------------
------------------XXX-----------
-----<>--<>----<-XXX---<>----<>-
-----[]--[]----]XXXX---[]----[]-
XXXXXXXXXXXXXXXXXXXXXXXXXXXXXXXX
