--------------------------------
--------------------------------
--------------------------------
---------------S----------------
---S--S-------------------------
--------------------------------
--------------------------------
--------------------------------
--------------------------------
--------------------------------
-------------------XX-----------
-----<>--<>----<>XXX---<>----<>-
--{--[]--[]----[]XXX---[]----[]-
XXXXXXXXXXXXXXXXXXXXXXXXXXXXXXXX
