--------------------------------
--------------------------------
--------------------------------
--------------------------------
--------------------------------
---------SS-S-------------------
--------------------------------
----------------------------S---
------------SS------------------
--------------------------------
--------------------------------
-----<>--<>---<>---<>---<>--<>--
--{--[]--[]---[]---[]---[]--X]--
XXXXXXXXXXXXXXXXXXXXXXXXXXXXXXXX
