--------------------------------
--------------------------------
--------------------------------
--------------------------------
--------------------------------
--------------------------------
--------------------------------
--------------------------------
--------------------------------
--------------------------------
------------------XX------------
-----<>--<>---<>-XX----<X----}--
--{--[]--[]---[]XXX----XX----X--
XXXXXXXXXXXXXXXXXXXXXXXXXXXXXXXX
