--------------------------------
--------------------------------
--------------------------------
--------------------------------
--------------------------------
--------------------------------
--------------------------------
--------------------------------
--------------------------------
--------------------------------
--------------------------------
-----<>--<>---<>-XX----<>-------
--{--[]--[]---[]XXX----[]-------
XXXXXXXXXXXXXXXXXXXXXXXXXXXXXXXX
