--------------------------------
--------------------------------
--------------------------------
--------------------------------
--------------------------------
--------------------------------
--------------------------------
----------------------------S---
----------------SSSSQ-----------
-----------X--------------------
----------XX-------------X------
------->--XXX---------X-XXX--}--
---{--[]XXXXX--------XXXXXX--X--
XXXXXXXXXXXXXXXXXXXXXXXXXXXXXXXX
