--------------------------------
--------------------------------
--------------------------------
--------------------------------
--------------------------------
-----------------S--------------
--------------------------------
----------------------------SS--
---------------SS-SSS-----------
--------------------------------
--------------------------------
------<>--<>----<><>------------
---{--[]--[]-------]------X-----
XXXXXXXXXXXXX--XXXXXX---XXXXXXXX
