--------------------------------
--------------------------------
--------------------------------
--------------------------------
--------------------------------
--------------------------------
--------------------------------
--------------------------------
--------------------------------
--------------------------------
------------------XX------------
-----<>--<>---<>-XXX---<>-------
--{--[]--[]---[]XXXX---[]-------
XXXXXXXXXXXXXXXXXXXXXXXXXXXXXXXX
