--------------------------------
--------------------------------
--------------------------------
--------------------------------
--------------------------------
--------------------------------
--------------------------------
--------------------------------
--------------------------------
--------------------------------
--------------------------------
-----<>---<---<>-XX--<>-XX---}--
--{--[]---XX--[]XXX--[]XXXX--X--
XXXXXXXXXXXXXXXXXXXXXXXXXXXXXXXX
