--------------------------------
--------------------------------
--------------------------------
--------------------------------
---------------------------S----
----------------------S---------
--------------------------------
---------S--------S-------------
--------------------------------
--------------------------------
--------------------------------
-----<>--------<>--XX--<>-------
--{--[]--------[]--XX--[]-------
XXXXXXXXXXXXXXXXXXXXXXXXXXXXXXXX
