--------------------------------
--------------------------------
--------------------------------
--------------------------------
--------------------------------
--------------------------------
--------------------------------
----------------------------S---
------------S---S--SQ-----------
--------------------------------
--------------------------------
------<>--<>------<>----<X---}--
--{---[]--[]-------]----XX------
XXXXXXXXXXXXXXXXXXXXXXXXXXXXXXXX
