--------------------------------
--------------------------------
--------------------------------
--------------------------------
--------------------------------
------------S----S--------------
--------------------------------
----------------------------S---
-----------SSS-SS--S------------
--------------------------------
--------------------------------
-----<>---<>------<<>---<>--<>--
--{--[]---[]-------[]---[]--[]--
XXXXXXXXXXXXXXXXXXXXXXXXXXXXXXXX
