--------------------------------
--------------------------------
--------------------------------
--------------------------------
--------------------------------
--------------------------------
--------------------------------
--------------------------------
--------------------------------
--------------------------------
--------------------------------
-----<>-------<--XX----<>----}--
--{--[]--[XX--[]XXX----X]----X--
XXXXXXXXXXXXXXXXXXXXXXXXXXXXXXXX
