--------------------------------
--------------------------------
--------------------------------
--------------------------------
--------------------------------
--------------------------------
--------------------------------
--------------------------------
----------------SSSSQ-----S-----
--------------------------------
--------------------------------
------<>---XX---<>---<>--XX-----
---{--[]--[]X---[]---[]--XXX----
XXXXXXXXXXXXXX-XXXXXXX-XXXXXXXXX
