--------------------------------
--------------------------------
--------------------------------
--------------------------------
---S--S-------------------------
------------S-------------------
--------------------------------
----------------------------S---
------------SS------------------
--------------------------------
--------------------------------
-----<>--<>---<>---}----<>--}>--
--{--[]--[]---[]---X]---[]--XX--
XXXXXXXXXXXXXXXXXXXXXXXXXXXXXXXX
