--------------------------------
--------------------------------
--------------------------------
------------SSSS----------------
---SS-S--------------------S----
----------------------S---------
--------------------------------
----SSS--SQS------SS------------
-----------------------Q--------
--------------------------------
--------------------------------
-----<>--------<>--<>--<>---}---
-----[]--------[]--[]--[]---X---
XXXXXXXXXXXXXXXXXXXXXXXXXXXXXXXX
