--------------------------------
--------------------------------
--------------------------------
--------------------------------
--------------------------------
--------------------------------
--------------------------------
--------------------------------
--------------------------------
--------------------------------
-------------------XX-----------
-----<>--<>----<>-XX---<>-------
--{--[]--[]----[]XXXX--[]-------
XXXXXXXXXXXXXXXXXXXXXXXXXXXXXXXX
