--------------------------------
--------------------------------
--------------------------------
--------------------------------
--------------------------------
--------------------------------
--------------------------------
--------------------------------
--------------------------------
--------------------------------
------------------XX------------
-----<>--<>---<>-XXX---<>----}--
--{--[]--[]---[]XXXX---[]----X--
XXXXXXXXXXXXXXXXXXXXXXXXXXXXXXXX
