--------------------------------
--------------------------------
--------------------------------
--------------------------------
--------------------------------
----------------------S---------
--------------------------------
--------------------------------
--------------------------------
--------------------------------
--------------------------------
-----<>--------<>--<>--<>---}---
--{--[]--------[]--[]--[]---X---
XXXXXXXXXXXXXXXXXXXXXXXXXXXXXXXX
