--------------------------------
--------------------------------
--------------------------------
--------------------------------
--------------------------------
----------------------S---------
--------------------------------
--------------------------------
--------------SSQ------Q--------
--------------------------------
--------------------------------
------<>--------<--<>--<>---}---
------[]-----------[]--[]---X---
XXXXXXXXXXXXX-XXXXXXXXXXXXXXXXXX
