--------------------------------
--------------------------------
--------------------------------
--------------------------------
--------------------------------
--------------------------------
--------------------------------
--------------------------------
--------------------------------
--------------------------------
------------X-------------------
-----<>----XX--<<>-----<>----<>-
--{--[]---XXX--[[X-----[]----X--
XXXXXXXXXXXXXXXXXXX--XXXXXXXXXXX
