--------------------------------
--------------------------------
--------------------------------
--------------------------------
---S----------------------------
--------------------------------
--------------------------------
--------------------------------
-------------S------------------
--------------------------------
--------------------------------
-----<>--<>--------<>--<>----}--
--{--[]--[]--------[]--[]----X--
XXXXXXXXXXXXXXXXXXXXXXXXXXXXXXXX
