--------------------------------
--------------------------------
--------------------------------
--------------------------------
------Q-------------------------
--------------------------------
--------------------------------
--------------------------------
--------SQ---------X------------
------------------XXX-----------
------------------XXXX----------
------------X----XXXXXX----}----
--{----]---XXX---XXXXXXX---X----
XXXXXXXXXXXXXXX-XXXXXXXXXXXXXXXX
