--------------------------------
--------------------------------
--------------------------------
--------------------------------
--------------------------------
--------------------------------
--------------------------------
--------------------------------
------SSSSSSQS------------------
--------------------------------
---------------------XX---------
--------<>-----------XXX-----}--
--{-----[]----[]----XXXX-----X--
XXXXXXXXXXXXXXXXXXXXXXXXXXXXXXXX
