--------------------------------
--------------------------------
--------------------------------
--------------SS-S---------S-S--
--------------------S-----------
--------------------------------
--------------------------------
-------SSS-----S-----------QS---
----------------------Q---------
--------------------------------
--------------------<>----X-----
------<>-X------<>--[]---XX-----
---{--[]XX------[]--[]--XXX-----
XXXXXXXXXX----XXXXXXXXXXXXXXXXXX
