--------------------------------
--------------------------------
--------------------------------
--------------------------------
-----SQ-------------------------
--------------------------S-----
--------------------------------
----------------XX---S-------Q--
---------------XXX------SS------
--Q------------XXXX-------------
--------------XXXXX-------------
------------XXXXXXXX------}-----
--{--------XXXXXXXXXX-----X-----
XXXXXXXXXXXXXXXXXXXXXXXXXXXXXXXX
