--------------------------------
--------------------------------
--------------------------------
--------------------------------
---------------------Q----------
------------S-------------------
----------------S---------------
--------------------------------
--------------------------------
-----------X--------------------
----------XX--------------------
------<>-XXX---<>--------<>-----
------[]XXXX---[]--------[]-----
XXXXXXXXXXXXXXXXXXXXXXXXXXXXXXXX
