--------------------------------
--------------------------------
---------------------S----------
--------------------------------
--------------SS----------------
----Q---------------------------
--------------------------------
--------------------SQSQ--------
-----------------------------S--
--------------------------------
-------------------------Q------
-----<>----<>--<>--<>-------}---
--{--[]----[]--[]--[]-------X---
XXXXXXXXXXXXXXXXXXXXXXX---XXXXXX
