--------------------------------
--------------------------------
--------------------------------
--SQSQQ-------------------------
--------------SQ----------SQ----
--------------------S-----------
--------------------------------
----Q--------------------SSQ----
-------Q------------------------
--------------------------------
-----<>------------------X------
-----[]-X------<>---}---XX---}--
--{--[]X-------[]---X--XXX---X--
XXXXXXXXX--XXXXXXXXXXXXXXXXXXXXX
