--------------------------------
--------------------------------
--------------------------------
-----------------------------S--
----------------SSS-SS----------
--------------------------------
--------------------------------
-------------------------SQSQ---
--------------------------------
---------XX---------------------
---------X----------------X-----
-----<>-XX-----<>--------XX--}--
--{--[]XXX-----[]-------XXX--X--
XXXXXXXXXXX-XXXXXXXXXXXXXXXXXXXX
