--------------------------------
--------------------------------
--------------------------------
-------------------------Q------
--------------------------------
-------------S------------------
--------------------------------
-----------------Q----Q---------
--------S------S---------S------
--------------------------------
---------------------X----------
---------<>--<>------XX--<>--}--
--{------[]--[]X-----XXX-[]--X--
XXXXXXXXXXXXXXXXX----XXXXXXXXXXX
