--------------------------------
--------------------------------
--------------------------QQ----
--------------------------------
--------------------------------
--------------------------S-----
---Q---------QSQSQ--------------
-----------------------Q-----S--
-------------------X------------
------------X-------------------
-----------XX------XX-----------
----------XXX--<>-XXXX-----}----
-----{---XXXX--[]XXXXX-----X----
XXXXXXXXXXXXXXXXXXXXXXXXXXXXXXXX
