--------------------------------
--------------------------------
---------------SS---------------
--------------------------------
--------------------------------
-------Q--------SQ--------------
--------------------------------
--------------------------------
-----------S--S-------X----S----
----------------------XX--------
-----S------------<---XXX-------
-------------<>---[]--XXXX---}--
--{----------[]---[]--XXXXX--X--
XXXXX------XXXXXXXXXXXXXXXXXXXXX
