--------------------------------
--------------------------------
--------------------------------
--------------------------------
--S--------S--------------------
--------------------------------
---------------------S----------
----------SQS-------------------
--------------------------------
-------------------------X------
-----<>-----------------XX------
-----[]--<>---X-----<>-XXX--}---
--{--[]--[]--XXX----[]XXXX--X---
XXXXXXXXXXXXXXX---XXXXXXXXXXXXXX
