--------------------------------
--------------------------------
--------------SQ----------------
------Q-------------------------
--------------------------------
-----------Q----SQ-----SS-------
-----S--------------------------
--------------------------------
----------------------X---------
----------------------XX--------
-----S-------<>-------XXX-------
---------<>--[]-------XXXX---}--
--{------[]--[]-------XXXXX--X--
XXXXX----XXXXXXXXXXXXXXXXXXXXXXX
