--------------------------------
--------------------------------
--------------------------------
--------------SS-S---------S----
--------------------------------
--------------------------------
--------------------------------
-----SSSS------S-Q----------S---
---------------------S----------
--------------------------Q-----
---------------X----------------
---------X----XXX---[]-------}--
--{----XXX----XXXX--[]-------X--
XXXXXXXXXXX----XXXXXXXXXXXXXXXXX
