--------------------------------
--------------------------------
--------------------------------
--------------SS-S--------------
--------------------SS----------
--------------------------------
------------------Q------S------
-------SSS------------------S---
--------------------------------
-------------Q------------------
--------------------<>----------
-----<>-X-------<>--[]---X---}--
--{--[]XX-------[]--[]----X--X--
XXXXXXXXX-----XXXXXXXXXXXXXXXXXX
