--------------------------------
--------------------------------
--------------------------------
--------------------------------
--------------SS----------------
---SQSSQ------------------------
--------------------------------
--------------------------------
------------S-------------------
--------------------------------
-----------------------X--------
-----<>----<>--<>--<>---XX--}---
--{--[]----[]--[]--[]--XXX--X---
XXXXXXXXXXXXXXXXXXXXXXXXXXXXXXXX
