--------------------------------
--------------------------------
--------------------------------
--------------------------------
--S-----------------------------
-----------------------SS-------
--------------------------------
-----SS----Q-QS--Q--------------
--------------------------------
--------------------------------
-----Q------------------X-------
---------<>--<>--------XXX---}--
--{------[]--[]-------XXXXX--X--
XXXXX----XXXXXXXX-XXXXXXXXXXXXXX
