--------------------------------
--------------------------------
--------------------------------
-----------------S--------------
--------------------------------
------------SSQ-----------------
----------------SS--------------
-----------------------------S--
------------------S--S----Q-----
--------------------------------
----------X---------------S-----
------<>-XX--<>-X------------}--
--{---[]XXX--[]XXX-----------X--
XXXXXXXXXXXXXXXXXX------X--XXXXX
