--------------------------------
--------------------------------
--------------------------------
------Q-------------------------
--S-----------------------------
---------------Q----------------
-----S--------------------------
------S----------Q--------------
--Q------------S---------S------
---------------------XX---------
-----S-------X-------XX---------
---------<>--XX-------XXX----}--
---------[]--XXX------XXXX---X--
XXXXX--XXXXXXXXXX-----XXXXXXXXXX
