--------------------------------
--------------------------------
------S---------SSS-------------
--------------------------------
-----------------------------S--
-----QSQ---------------------Q--
--------------------Q-----------
--------------------------------
---------------------------SS---
----------S---------------------
----------S-------------X-------
------X-------<>--[]---XXX---}--
--{--XX-------[]--[]---XXXX--X--
XXXXXXX-----XXXXXXXXXXXXXXXXXXXX
