--------------------------------
--------------------------------
---------------Q----------------
--------------------------------
--S-----------------------------
-----------Q---SSQ-----SSS---Q--
-----S--------------------------
--------------------------------
--------------------------------
----------------------XX--------
-----X------------<>--XXX-------
-------------<>---[]---XXX---}--
--{----------[]---[]--XXXXX--X--
XXXXX------XXXXXXXXXXXXXXXXXXXXX
