--------------------------------
--------------------------------
--------------------------------
--------------------------------
--------------------------------
--------------------------------
--------------------------------
--------------------------------
--------------------------------
--------------------------------
--------------------------------
------------XX------------}-----
--{--{-----XXXX-----------X-----
XXXXXXXX--XXXXXXXXXXXXXXXXXXXXXX
