--------------------------------
--------------------------------
--------------------------------
------------------------S-------
--------------------------------
--------------------S-----------
--------------------------------
-SQS---------------------SSSS---
--------------------------------
--------------------------------
------------<>--X--XXX----------
------------<>-----XXX----}-----
---{--------[]-XX--XXX----X-----
XXXXXXX--XXXXXXXXXXXXXX---XXXXXX
