--------------------------------
--------------------------------
--------------------------------
----------------------S---------
---S---------------------SS-----
---------------Q--SS------------
--------------------------------
----------XX--------------------
---------XXX---Q-------S--------
--------XXX---------------------
-------XXXXX--------------------
------XXXXXX-----XXX----<>---}--
----{XXXXXXX----XXXXX---[]---X--
XXXXXXXXXXXXXXXXXXXX--XXXXXXXXXX
