--------------------------------
--------------------------------
--------------------------------
--------------------------------
--------------------------------
--------------------------------
--------------------------------
--------------------------------
--------------------------------
--------------------------------
--------------------------------
--------X----XX-------[]--}-----
--{----XX----XX-------[]--------
XXXXXXXXXXXXXXXXXXXXXXXXXXXXXXXX
