--------------------------------
--------------------------------
--------------------------------
--------------------------------
--------------------------------
--------------------------------
--------------------------------
--------------------------------
--------------------------------
--------------------------------
--------------------------------
------------X-------------}-----
-----------XX----------]--X-----
XXXXXXXXXXXXX---XXXXXXXXXXXXXXXX
