--------------------------------
--------------------------------
--------------------------------
--------------------------------
--------------------------------
--------------------------------
--------------------------------
--------------------------------
---------------------X----------
--------------------------------
------------->------XX----------
--------X----]-----XXX-------}--
--{----XX---[]-----XXX-------X--
XXXXXXXXXXXXXXXXXXXXXX----XXXXXX
