--------------------------------
--------------------------------
--------------------------------
------------Q---------S---------
-------------------------S------
---------------Q--S------S------
--------------------------------
----S-----XXX--------X----------
----------XXX--Q---XX-------SQ--
--------XXXXX----X-XX-----------
-------XXXXXX-----XXX-----------
------XXXXXXX----XXXX---<>---}--
--{--XXXXXXXX---XXXXX---[]---X--
XXXXXXXXXXXXXXXXXXXXXXXXXXXXXXXX
