--------------------------------
--------------------------------
--------------------------------
------------S-------------------
--------------------------------
---------S---------------S------
--------------------------------
--------------XX----------------
---SS-------X-X-------------S---
----S-----XXX--X---<>-----------
----------XXX--X---[]-----------
----------XXX--X---[]-----}--}--
---{------XXXXXX---[]-----X--X--
XXXXXXXXXXXXXXXX--XXXXXXXXXXXXXX
