--------------------------------
--------------------------------
--------------------------------
----------------------SS-S------
--------------------------------
-------------------------S------
--------------------------------
----S---------------------------
--------------------XX----------
--------XX---------XX-----------
--------XX--<---X--XXX--S-------
------XXXX--[---XX-XX--------}--
-----XXXXX--[]-XX--XXX----X--X--
XXXXXXXXXXXXXXXXXXXXXXXXXXXXXXXX
