--------------------------------
--------------------------------
--------------------------------
--------------------------------
--------------------------------
---------------------SQSSS--SS--
--------------------------------
--------------------------------
--------------------------------
---------------X---SQ-S---------
--------------X----S------X-----
------------XXXX---------XX--}--
-----------XXXXX---------XX--X--
XXXXX---XXXXXXXXXXXXXXXXXXXXXXXX
