--------------------------------
--------------------------------
--------------------------------
--------------------------------
--------------------------------
--------------------------------
--------------------------------
--------------------------------
--------------------------------
--------------------------------
-------XXX----------------------
-------XXX-------------X----}---
--{---XXXX------------XXX---XX--
XXXXXXXXXXXXXXXXXX---XXXXXXXXXXX
