--------------------------------
--------------------------------
--Q-----------------------------
--------------------------------
--------------------------------
--------------------------------
---------------------SS---------
--------------------------Q-----
--------------------------------
-------------------XXX----------
------------------XXX-XX--------
-----<>---->XX----XXX-XXX----}--
--{--[]----XXX--XXXX--XXXX---X--
XXXXXXXXXXXXXXXXXXXX--XXXXXXXXXX
