--------------------------------
--------------------------------
---------------------SS---------
--------------------------------
-------------SS-----------------
--------------------------------
----------SS--------------------
-------------------------S---Q--
--------------------------------
--------------------------------
-----------------------X--------
----------<>-XX-XX----XXX---}---
--{-------[]XXX-XX----XXX---X---
XXXXX--XXXXXXXXXXX---XXXXXXXXXXX
