--------------------------------
--------------------------------
--Q-----------------------------
--------------------------------
--------------------------------
-----S--------------------------
--S---------------QSSS-------Q--
--------------------------------
--------------------------Q-----
---------------------SSQ--------
-----<>-------SQ----------------
-----[]---XX------XX------}--}--
--{--[]---XX------XXX--XX-X--X--
XXXXXXXXXXXXXXXXXXXXXXXXXXXXXXXX
