--------------------------------
--------------------------------
--------------------------------
--------------------S---Q-S-----
---S----------------------------
--------------------------------
----------------------S-S-------
--Q---------Q-------------------
----------------S--Q------------
--------------------------------
-----------------------S--Q-----
-----<>-----<>---<>----------}--
--{--[]-----[]---[]----------X--
XXXXXXXXX--XXXXXXXXXXX--XXXXXXXX
