--------------------------------
--------------------------------
--------------------------------
--------------------S-----S-----
--------------------------------
-----------------------SQ-------
---------Q-----------------S----
------------X-------------------
------------X------Q------------
---------X-------------S--------
---------XX-Q-------------------
-----<>-XX--------<>-----X---}--
--{--[]XXX--X-----[]X----XX--X--
XXXXXXXXXXXXX---XXXXXX--XXXXXXXX
