--------------------------------
--------------------------------
--------------------------------
--------------------------------
---------------SSS--------------
--------------------------------
--------------------------------
---------------------------SS---
------------------------SQ------
---S--Q-------------------------
--------------------------------
-----------<>--<>---------}-}---
-----------[]--[]--X------X-X---
XXXXXXXXXXXXXXXXXXXXXX--XXXXXXXX
