--------------------------------
--------------------------------
-----S---S----------------------
-------------------S------------
---------------S----------------
----------------------SSQS------
----SQ-------------S------------
--------------------------------
--Q----------------------SQ-----
------------X-------------------
-----------XX--------S----------
-----XX-->-XX--<>--X-----XX--}--
--{--XX--]XXX--[]--XX----XX--X--
XXXXXXXXXXXXX---XXXXXX--XXXXXXXX
