--------------------------------
--------------------------------
--------------------------------
-------------------------S------
--------------------------------
----------QS--------------------
----------------Q---S--S-----Q--
--------------------------------
----SS---------S----------Q-----
----------------------SQ--------
-----------X------X-------------
----------XX--<>-XXX---------}--
--{------XXX--[]-XXX---------X--
XXXXXXXXXXXXXXXXXXXXXXXX---XXXXX
