--------------------------------
--------------------------------
--------------------------------
-------------------------Q------
--------------------------------
--------------------------------
--------------------------------
--------------------------------
--------------------------------
---------------------SSQ--------
------------------X-------------
----------<>--<>-XX-------}--}--
--{-------[]--[]XXX-------X--X--
XXXXXXXXXXXXXXXXXX---XXXXXXXXXXX
