--------------------------------
--------------------------------
--------------------------------
--------------------------------
--------------------------------
--------------------------------
---------------------------S----
--------------------------------
--------------------------------
--------------------------------
------------------<>------------
-----<>------XX---[]----XX---}--
--{--[]-----XXX---[]----XXX--X--
XXXXXXXXXXXXXXXXXXXXXX--XXXXXXXX
