--------------------------------
--------------------------------
----------------------------SS--
--------------------------------
-------------SS-----------------
--------------------------------
--S-----------------------------
--------------------------------
--------------------------------
---------------X---------XX-----
------Q-------XX--------XXX-----
----------<>-XXX----<>-XXXX--}--
--{-------[]XXXX----[]XXXXX--X--
XXXXX--XXXXXXXXXXXXXXXXXXXXXXXXX
