--------------------------------
--------------------------------
--------------------------------
--------------------S-----------
--------------------------------
----------------S---------------
--------------------------------
------------Q---------Q---Q--S--
--------------------------------
--------------------------------
----------------------XX--------
-----<>-X---<>------X--XX----}--
--{--[]XX---[]-----XX--XXX---X--
XXXXXXXXXXXXXXXXXXXXXXXXXXXXXXXX
