--------------------------------
--------------------------------
--------------------------------
--------------------------------
---------------SSSQ-S-----------
--------------------------------
--------------------------------
-----------S----S---------------
-----------------------Q--------
---S----------------------------
--------------------------------
--------<>-XX--<>--}------}-----
-----{--[]XXX--[]--X-X----X-----
XXXXXXXXXXXXXXXXXXXXXXXXXXXXXXXX
