--------------------------------
--------------------------------
--------------------------------
--------------------------------
--------------------------------
--------------------------------
--------------------------------
--------------------------------
--------------------------------
---S--S-------------------------
--------------------------------
-----------<>--------S-------}--
-----{-----[]--------S-------X--
XXXXXXXXXXXXX-------------------
