--------------------------------
--------------------------------
--------------------------------
--------------------------S-----
--------------------------------
--------------------------------
-----------------------S--------
----------------------------Q---
-----S---------SS---------------
-----------------------S--------
------------------X-------------
------<>--<>--<>-XX----------}--
--{---[]--[]--[]XXX----------X--
XXXXXXXXXXXXXXXXXXXX--XXXXXXXXXX
