--------------------------------
--------------------------------
--------------------------------
--S-----------------------------
--------------------------------
------SS----------------S---S---
--------------------------------
---------------Q--Q-------------
----S--------------------X------
------------------------XX------
-----------------------XXX------
------<>------<>-XX---XXXX---}--
--{---[]------[]-XX--XXXXXX--X--
XXXXXXXXXXXXXXXXXXXXXXXXXXXXXXXX
