--------------------------------
--------------------------------
--------------------------------
----------------------SQ--------
--------------------------------
----Q--S------Q-----------------
--------------------------------
---SQ---------------------------
-----------------------XX-------
-----------------------XX-------
---------XX----------XXXX-------
-----<>-XXX--<>--<>-XXXXX-------
-----[]XXXX--[]--[]XXXXXX-------
XXXXXXXXXXXXXXXXXXXXXXXXX--XXXXX
