--------------------------------
--------------------------------
--------------------------S-----
--------------------------------
-------------QS-----------------
------S--S-------------------S--
--------------------------------
------------S-----------Q-------
------Q---------Q--S-------SS---
--------------------------------
--------------------------------
-<>----<>--<>---XX--<>------}---
-[]----[]--[]--XXX--[]------X---
XXXXXXXXXXXXXXXXXXXXXXXXXXXXXXXX
