--------------------------------
--------------------------------
--------------------------------
----------------SS--------------
--------------------------------
--------------------SQQ---------
---------SQ---Q-----------------
-----------------S--------------
---------------------S----------
-----S-------------------S------
------------X-------------------
--------<>-XX-------<>-------}--
----{---[]XXX-------[]-------X--
XXXXXXXXXXXXXX--XXXXXXXXXXXXXXXX
