--------------------------------
--------------------------------
--------------------------------
--------------------------------
-----------SS-------------------
--------------------------------
--------------------------------
----------------S---------------
---------------------------SS---
-------Q--S---------------------
-----------------<>-------------
-------------<>--[]-----X-------
---{---X-----[]--[]-----XX-X----
XXXXXXXXX--XXXXXXXXXX---XXXXXXXX
