--------------------------------
--------------------------------
----------------------------Q---
--------------------------------
------------------------SS------
--------------------------------
---------------------Q------SQ--
-------------------X------------
------------------XX----S-------
-----------------XXX------------
-----------------XXX------------
-----------<----XXXX---------}--
--{--------[]--XXXXX---------X--
XXXXXXX---XXXXXXXXXXXXXXXXXXXXXX
