--------------------------------
--------------------------------
-----------------------------S--
--------------------------------
--------------------------------
------S----------------------Q--
-----Q--------------------------
--------------------------------
-----------------------SQ--Q----
--------------------------------
-----<>------XX-----------------
-----[]------XXX------XXX----}--
--{--[]-----XXXXX-----XXX---XX--
XXXXXXXXXXXXXXXXX--XXXXXXXXXXXXX
