--------------------------------
--------------------------------
--------------------------------
--------------------------------
--------------------------------
-----------------------------S--
--------------------------------
--------------------------SS----
--------------------------------
------------Q-----SQ------------
--------------------------------
----------------------------}---
--{-------------------------X---
XXXXX---XXXXXXXXX--XX-XX--XXXXXX
