--------------------------------
--------------------------------
--------------------------------
-----------------------------Q--
------------------------S-------
------S-------------------------
-----Q---------SSS--------------
----------------------X---------
---------------------XX---SS----
--------------------XXX---------
------QS-----------XXXX---------
------------------XXXXX------}--
--{---------X----XXXXXX------X--
XXXXXXXXXXXXXXXXXXXXXXXXXX--XXXX
