--------------------------------
--------------------------------
--------------------------------
--------------------------------
--------------------------------
-----------------------------S--
-----------------Q--------------
--------------------------S-----
--------------------------------
------------<>----SSS-----------
------------[]------------------
------------[]--------------}---
--{---------[]--------------X---
XXXXX---XXXXXXXXXXXXXXXXX-XXXXXX
