--------------------------------
--------------------------------
--------------------------------
---------------Q-Q--------------
------S-----------------S-------
-SQ---------S-------SS----------
--------------------------------
---------S-----S----------------
---SS--------S-------------SQ---
->------------------------------
-SS----<>-----------------------
>------[]--------<>-----<>--}---
->-----[]--------[]-----[]--X---
X>--XXXXXXXXXXXXXXXXXXXXXXXXXXXX
