--------------------------------
--------------------------------
--------------------------------
--------------------------------
----------------------------SQ--
--------------------------------
--------------------------------
--------------------------------
--------------------------------
-----------------S--------------
-------------X------------------
------->-----XX------------}----
----{--]--X--XXX----X------X----
XXXXXXXXXXX--XXXXXXXX----XXXXXXX
