--------------------------------
--------------------------------
--------------------------------
--------------------------------
------------------------S-------
--------------------------------
--------------------------------
--------------------------------
---------------------X----S-----
-------------------XXX----------
-------------------XXX----------
-----------------XXXXX--<>---}--
--{--------XX---XXXXXX--[]---X--
XXXXXXXXXXXXXXXXXXXXXXXXXXXXXXXX
