--------------------------------
--------------------------------
--------------------------------
---------------S----------------
-----------S--------------------
-----------------------S--------
---------------SS---S-----------
--------------------------------
----------------------------SQ--
--SS-------------Q--------------
-----------X--------------------
-------<>-XX-----<>--------}----
----{--[]XXX-X---[]-X------X----
XXXXXXXXXXX----XXXXXXX--XXXXXXXX
