--------------------------------
--------------------------------
--------------------------------
------------------Q-------------
--------------------------------
-------S--------------Q--SQQ----
--------------------------------
---S-Q------------XX------------
-----------------XXX-----Q------
-----------X----XXXX------------
--------XXXXX--XXXXX------------
---------XXXX--XXXXX------}-----
--{--XX-XXXXXX-XXXXX------X-----
XXXXXXXX-XXXXXXXXXXX--XXXXXXXXXX
