--------------------------------
--------------------------------
----------------------------S---
----------------------S---------
--------------------------------
--------------------------------
---------------------S----------
---------------------S---S------
------------------X-------------
-----------------XX-------------
----------------XXX-------------
------X--------XXXX-------}--}--
--{--XX---X---XXXXX-------X--X--
XXXXXXX--XXXXXXXXXX---XXXXXXXXXX
