--------------------------------
--------------------------------
---------------------------S----
------------Q-------------------
--------------------------------
-------S----------------SQSS----
------------------S-------------
------------X-------------------
-----------XX-------------------
----------XXX---------XX--------
---------XXXX---------XX--------
--------XXXXXX--------XX-----}--
-----{-XXXXXXX--------XX-----X--
XXXXXXXXXXXXXXX----X--XXXXXXXXXX
