--------------------------------
--------------------------------
--------------------------------
--------------------------------
--------------------------------
--------------------------------
--------------------------------
---S-Q--------------------------
------------------XX------------
------------------XX------------
-----------------XX-------------
------X---X-----XXXX------}--}--
--{--XX---XX---XXXXX------X--X--
XXXXXXXX--XXXXXXXXXX--XXXXXXXXXX
