--------------------------------
--------------------------------
--------------------------------
---------------S----------------
----------S---------------S-----
-----------------------S--------
----------------S---S-----------
--------------------------------
-------------------------S--SQ--
-------<>-----------------------
-------[]------------X----------
>------[]----X---<>-XX-----}----
-------[]----XX--[]XXX-----X----
X--XXXXXXXXXXXXXXXXXXXXXXXXXXXXX
