--------------------------------
--------------------------------
--------------------------------
--------------------------------
--------------------------------
-----QQQQ-----------------------
--------------------------------
--------------------------------
-----------SQ---Q----------S----
--------------------------------
-----------------------X--------
-----------<>------<>-XX--------
--{--------[]------[]XXX---XX---
XXXXX----XXXXXXXXXXXXXXXXXXXXXXX
