--------------------------------
--------------------------------
--------------------------------
--------------------------------
--------------------------------
--------------------------------
--------------------------------
-----------------------Q--------
--------S-----------------------
--------------------------------
--------------------------------
-----<>--<>----<>---XX-----}----
-----[]---]XX--[]--XXXX----X----
XXXXXXXXXXXXXXXXXXXXXXX--XXXXXXX
