--------------------------------
--------------------------------
--------------------------------
--------------------------------
--------------SSS---------------
--------------------------------
--------------------------------
--------------------------------
-----SQS---------------S--------
--------------------------------
--------------------------------
-----<>--------<>--<>---XX--}---
--{--[]--------[]--[]--XXX--XX--
XXXXXXXXX---XXXXXXXXXXXXXXXXXXXX
