--------------------------------
--------------------------------
--------------------------QQS---
--------------------------------
--------------------------------
------------S-------------S-----
---------------QSQ--------------
-------------------X---------S--
-------------------XX-----Q-----
-------------------XX-----------
-----------XX------XXX----------
-----------XX--<>-XXXXX---}-----
----{{---XXXX--[]XXXXXXX--XX----
XXXXXXXXXXXXXXXXXXXXXXXXXXXXXXXX
