--------------------------------
--------------------------------
--------------------------------
--------------------------------
-----SQ------------Q------------
--------------------------------
--------------------------------
------------------X-------------
---------------X--X------S------
--------------XXX-X-------------
--------------XX--X--X----------
------------XXXX-XXX-XX---------
--{--------XXXXX-XXXXXXX--------
XXXXXXXXXXXXXXXX-XXXXXXXXXXXXXXX
