--------------------------------
--------------------------------
--------------------------------
--------------------------------
------Q-------------------------
---------S----------------------
--------------------------------
--------------------------------
--------------------------------
--------------------------------
------<>------------------------
------[]--<>---<>-XX--<>---}----
---{--[]--[]---[]XXX--[]---X----
XXXXXXXXXXXXXXXXXXXXX-X-XXXXXXXX
