--------------------------------
--------------------------------
--------------------------------
--------------------------------
------------Q--S----------------
--------------------------------
--------------------------------
-----------S--------------------
--------------------------------
------------------------S-------
--------------------------------
-----<>----<>--<>---------------
--{--[]----[]--[]-----------XX--
XXXXXXXXXXXXXXXXXXXXXXX----XXXXX
