--------------------------------
--------------------------------
----------------S---------------
--------------------------------
--------------------------------
------SQ------------------------
--------------------------------
--------------------------------
------SQ-SQSQ------S--------S---
----------------------XXXX------
----------------------XXXX------
--------------<>---<>-XXXX---}--
--{-----------[]---[]XXXXXX--X--
XXXXXXX-----XXXXXXXXXXXXXXXXXXXX
