--------------------------------
--------------------------------
--------------------------------
--S--Q--------------------------
--------------------------------
--------------------S-----------
--------------------------------
--------------------------------
-------Q-----------SS--Q--------
--------------------------------
--------------------------------
-----<>-X------<>--------X---}--
--{--[]XX------[]------------X--
XXXXXXXXX--XXXXXXXXXXXX----XXXXX
