--------------------------------
--------------------------------
--------------------------------
--------------------------------
-----SQ-----Q-----Q-------------
--------------------------Q-----
--------------------------------
-----------------X--SS----------
----------------XX------S-------
------<>--------XX--------------
------[>--------XXX----Q--------
------[]----X---XXXX-------}----
--{---[]---XX---XXXXX------X----
XXXXXXXXXXXXX--XXXXXX-----XXXXXX
