--------------------------------
--------------------------------
--------------------------------
--------------------------------
--------------------------------
--------------------------------
--------------------------------
--------------------------------
----------------------S---------
--------------------------------
--------------------------------
-----<>-X----<>-----<>-------}--
--{--[]XX----[]-----[]-------X--
XXXXXXXXX--XXXXXXXXXXXXX---XXXXX
