--------------------------------
--------------------------------
--------------------------------
--------------------------------
--------------------------------
-------S--Q----------------S----
--------------------------------
--------------------------------
--------SSS--------X------------
-------------------XX-----------
------------X------XXX----------
--------<>-XX--<>--XXXX----}----
----{---[]XXX--[]--XXXXX---X----
XXXXXXXXXXXXXXXXXXXXXXXXXXXXXXXX
