--------------------------------
--------------------------------
--------------------------------
--------------------------------
--------------------------------
--------------------------------
---------------------SQS--------
----------SS--------------------
--------------------------------
-------------------------X------
------------------------XX------
----------<>---<>------XXX------
--{--XX---[]---[]-----XXXX--XX--
XXXXXX--XXXXXXXXXXXXXXXXXXXXXXXX
