--------------------------------
--------------------------------
--------------------------------
---------------S----------------
-----------SQ-------------------
--------------------------------
----------------------S---------
---------SS-S------S------------
--------------------------------
--------------------------------
--------------------------------
-----<>---<>----<>--<>----------
--{--[]---[]----[]--[]----------
XXXXXXXXXXXXXXXXXXXXXXXX--XXXXXX
