--------------------------------
--------------------------------
--------------------------------
--------------------------------
--------------------------------
--------------------------------
--------------------------------
--------------------------------
------SS-------------Q-Q--S-----
-----------XX-------------------
----------XXX-------------------
------<>-XXX---<>----------}----
------[]XXXXX--[]----------X----
XXXXXXXXXXXXXXXXX--------XXXXXXX
