--------------------------------
--------------------------------
--------------------------------
--------------------------------
--------------SS----------------
----Q---------------------------
--------------------------------
--------------------------------
------SQ---------Q--------------
--------------------------------
-----------------------S--------
-----<>----X---<>--<>-------}---
--{--[]---XXX--[]--[]-------X---
XXXXXXXXXXXXXXXXXXXXXXX--XXXXXXX
