--------------------------------
--------------------------------
----Q------S--------------------
--------------------------------
-----S--------------------------
--------Q--Q-------------S-SSS--
-------------------S------------
------------------------Q-------
-----------SQSS-Q----------S----
--S-S-----------------X---------
--------S-------------XX--------
-----------<>---------XXX--}----
--{--------[]---------XXXX-X----
XXXXX----XXXXXX--XXXXXXXXXXXXXXX
