--------------------------------
--------------------------------
----------------S---------------
--------------------------------
--------------------------------
--------------------------------
--------------------------------
--------------------------------
------SQ-SQS--Q------XX---------
---------------------XXX--------
---------------------XXXX-------
--------<-----<>--->-XXXXX---}--
--{------]X---[]----XXXXXXX--X--
XXXXXXXXXXXXXXXXXXXXXXXXXXXXXXXX
