--------------------------------
--------------------------------
--------------------------------
---------------S----------------
--------Q-----------------------
--------------------------------
--------------------------------
-----SS-S-----------------------
----Q-----------------Q---------
--------------------------------
---------------X----<>----------
-----<>--<>----XX---[]----}-----
--{--[]--[]---XXXX--[]----X-----
XXXXXXXXXXXXX--XXXXXXXXXXXXXXXXX
