--------------------------------
--------------------------------
---------------QSS--------------
--------------------------------
--------------------------------
----------------S------------Q--
--------------------------------
--------------------------------
-------Q---S-------S------X-S---
----------S------------X-XX-----
--------------->-------XXXX-----
------X-------[]--<>--XXXXX--}--
--{--XX-------[]--[]--XXXXX--X--
XXXXXXX----XXXXXXXXXXXXXXXXXXXXX
