--------------------------------
--------------------------------
--------------------------------
----SQS--------------------S-S--
--------------------------------
--------------------------------
--------------------------------
---------------S--Q-------------
---------X------------Q---------
--------XX----------------X-----
-------XXX--------------XXX-----
------XXXX---<>-----<>--XXX--}--
--{--XXXXX---[]-----[]-XXXX--X--
XXXXXXXXXXXXXXXXXXXXXXXXXXXXXXXX
