--------------------------------
--------------------------------
--------------------------------
--------------------------------
--------------SS-----------S----
-------Q------------------------
--------------------------------
--------------------------------
--------------------------------
--------------------------------
--------------------------------
-----<>--------<>--<>-------}---
--{--[]--------[]--[]-------X---
XXXXXXXXXXXXXXXXXXXXXXXXXXXXXXXX
