--------------------------------
--------------------------------
------S-----------S-------------
---------------------------SQS--
----------------SQ--------------
--------------------------------
--Q-----------------------------
------------Q--S--SS------S-----
---S----------------------------
--------X----------Q------------
-------XX-S---<>---------XX-----
------XXX-----[]--------XXX--}--
---{-XXXX-----[]-------XXXX--X--
XXXXXXXXXXX-XXXXXX--XXXXXXXXXXXX
