--------------------------------
--------------------------------
--------------------------------
----------S---------------------
--------------------------------
-----------Q-----------SS-------
--------------------------------
--------------------------------
--------------------------------
--------------------Q-----------
-------------->--S--------------
---------XX--[]---------X----}--
---{-----XX--[]---------XXX--X--
XXXXXXXXXXXXXXXXXX-----XXXXXXXXX
