--------------------------------
--------------------------------
--------------------------------
--------------------------------
------------------Q-------------
--------------------------Q-----
----S--------QSQ----------------
--------------------SQSQ--------
--------------------------------
--------------------------------
-----<>-----X----------QQ-------
-----[]----XX--<>-----------}---
-----[]---XXX--[]-----------X---
XXXXXXXXXXXXXXXXXXXXXXXXXXXXXXXX
