--------------------------------
--------------------------------
----------------------------Q---
--------------S--S--------------
--------------------SS----------
--------------------------------
----------------SSQ-------------
-------Q--------------------S---
---------------------Q----------
----------X--Q------------------
---------XX----XX---S>-------Q--
------<>-XX-----XX--[]---<>-----
--{---[]XXX--X--XX--[]---[]-----
XXXXXXXXXXXXXX-XXXXXX--XXXXXXXX>
