--------------------------------
--------------------------------
--------------------------------
-------------------------Q------
------Q-------------------------
----------SQ--------------------
--------------------------------
--------------------XX----------
-------SSSS---------XX----------
----S---------------XXX---------
--------------------XXXX--------
-------------<>-----XXXXX----}--
----{--------[]-----XXXXXX---X--
XXXXXXXXXXXXXXXXXX-XXXXXXXXXXXXX
