--------------------------------
--------------------------------
---------------------<----------
---------------------[]---------
---------------------[]---------
-------S-SQ----------------S----
---------------Q----------------
-----------------------Q--------
---------SS---------------------
------S-------------------------
------------X------X------------
-----------XX------XX------}----
----{-----XXX------XXXX----X----
XXXXXXXXXXXXX------XXXXXXXXXXXXX
