--------------------------------
--------------------------------
----Q----------------Q----------
--------------------------------
-----S---------------------S----
---SQQQ-Q-----------------------
-------------------Q------------
--------------------------------
----------------Q-----------QS--
--------Q--<>-------------------
-----------[]-------------------
-----------[]------<>-X-----}---
--{--------[]------[]--X----X---
XXXXXXXXXXXXXXXXXXXXXXXXXXXXXXXX
