--------------------------------
--------------------------------
-----------S--------------------
--------------------------------
------Q------------Q------------
-----------Q----------S--S------
--------------------------------
--------------------------------
--S------------S----------------
--S------------------XX---------
------------------Q---XX--------
-------------XX-------XXX----}--
--{----------XXX------XXXX---X--
XXXXX---XXXX-XXX--X-XXXXXXXXXXXX
