--------------------------------
--------------------------------
--------------------------------
--------------------------------
--------------SSSQS-------------
---------------------S----------
------------S--------------SSS--
-------------------------QQS----
-----SQ----------Q--------------
--------------------------------
-----------SS------<>-----------
------X------------[]-------}---
-----XX------------[]-------X---
XXXXXXXXXX---XXXXXXXXXXXXXXXXXXX
