--------------------------------
--------------------------------
--------------------------------
--------------------------------
---------------------Q----------
--------------------------------
--------------------------------
--------------------SQ----------
--------------------------------
--------------------------------
-----<>---------<>------Q-------
-----[]-----XX--[]--<>------}---
--{--[]----XXX--[]--[]------X---
XXXXXXXXXXXXXXXXXXXXXXXX--XXXXXX
