--------------------------------
--------------------------------
--------------------------------
----------Q---------------------
--------------------------------
-----------SQ-------------------
--------------------Q-----------
--------------------------------
---------S----------------------
-------------------SQ-----------
--------------------------------
----------<>---------------}----
---{------[]---------------X-X--
XXXXXXXXXXX------------XXXXXXXXX
