--------------------------------
--------------------------------
--------------------------------
----------S----------------SQS--
----------------SQ--S-----------
--------------------------------
--------------------------------
--------------------------------
----------------------SQQ-------
-------------------Q------------
----------X----S----------------
---------XX--------------X---}--
---{----XXX------------------X--
XXXXXXXXXXX--------------XXXXXXX
