--------------------------------
--------------------------------
--------------------------------
--------------------------------
--S--------S-------Q------------
--------------------------------
-----S---S----------------------
-----------Q--X-----------------
--Q-----------XX---------S------
-----XX-------------------------
-----XX-------XX----------------
-----X--------XX--X---<>--------
--{---X------XXX--XX--[]-----X--
XXXXXXXXXXXX--XX--XX--XXXXXXXXXX
