--------------------------------
--------------------------------
--------------------------------
--------------------------------
-------------------S------------
---S----------------------------
--------------------------------
--------------------------------
------SS-Q-----X----------------
--------------XXX---------------
-------------XXXX---X-----------
-----<>--<>-XXXXX--XX--<>----}--
-----[]--[]XXXXXX-XXX--[]----X--
XXXXXXXXXXXXXXXXXXXXXX--XXXXXXXX
