--------------------------------
--------------------------------
--------------------S-----------
------------------------Q---Q---
---------------Q----------------
--------------------------------
----Q---------S-----------------
-----------------------------S--
--------------------------X-----
--SQSX-----<>----Q-------X------
-----X--Q--[]-----------XX------
-----XX----[]-------<>-XXX------
-----XX----[]-------[]XXXXX-----
XXXXXXX--XXXXXX---XXXXXXXXXXXXXX
