--------------------------------
--------------------------------
--------------------------------
--------------------------------
-------------------Q------------
-------S----S-------------------
--------------------------------
---Q-------------S--SQS---------
-------S-SS----S-----------S----
-------------Q------------------
----------------------SQ--------
------------------<>---------}--
---{----X---------[]---------X--
XXXXXXXXXX---XXXXXXX-----XXXXXXX
