--------------------------------
--------------------------------
--------------------------------
--------------------------------
--------------------------------
--------------------------------
--------------------------------
--------------------------------
---------------------X----------
---------------------XX---------
---------------------XXX--------
-----<>--<>------<>--XXXX-------
--{--[]--[]------[]--XXXXX--XX--
XXXXXXXXXXXXXXXXXXXXXXXXXXXXXXXX
