--------------------------------
--------------------------------
-------------------S-S----------
--------------------------------
-------------SQ---S-------------
--------------------------------
----------S---------------------
-----------------------S--------
--S-----------------------------
--------------------------------
--------------------------------
------<>---<>--<>---<>----}-----
--{---[]---[]--[]---[]----X-----
XXXXXXXXXXXXXXXXXXXXXXXXXXXXXXXX
