--------------------------------
--------------------------------
--------------------------------
--------------------------------
--------------S-S---------------
--------------------------------
--------------------------------
-----S--------------------------
-----------XX-------------------
----------XXX-------------------
---------XXXX---------<>--------
---------XXXX-<>------[]--}-----
--------XXXXX-[]------[]--X-----
XXXXXXXXXXXXXXXXXXXXXXXXXXXXXXXX
