--------------------------------
--------------------------------
--------------------------------
--------------------------------
-----------------SSQS-----------
--------------------------------
--------------------------------
--------------------------------
--------SS-----------------S----
--------------------------------
-------------------X---S--------
------<>-------<>-XX---------}--
-----{[]----X--[]XXX---------X--
XXXXXXXXXXXXXXXXXXXX-------XXXXX
