--------------------------------
--------------------------------
--------------------------------
--------------------------------
-------------S------------------
--------------------------------
--------------------------SSQ---
--------------------------------
---SQ-SQ---SSS------------------
------------------------SSQ-----
--------------------------------
------------XX--<>--X--------}--
--{--------XXX--[]-XX--------X--
XXXXX--XXXXXXXXXXXXXX------XXXXX
