--------------------------------
--------------------------------
--------------------------------
--------------------------------
---------------SSQ--------------
--------------------------Q-----
---------------------S----------
--------------------------------
--------------------------------
-----------------------SQ-------
--S-----------------------------
---------------<>-X--X-------}--
-----{------{--[]XX--XX------X--
XXXXXXXXXXXXXXXXXXX--XXXXXXXXXXX
