--------------------------------
--------------------------------
--------------------------------
--------------------------------
--------------S-----------------
--------------------------------
---------S----------------------
--------------------------------
---------------S----------Q-----
-----------X-------S------------
----------XX--------------------
------<>-XXX---X------<>--}-----
---{--[]XXXX---XX-----[]--X-----
XXXXXXXXXXXX---XX---XXXXXXXXXXXX
