--------------------------------
--------------------------------
----------S---------------Q--S--
--Q-----------------------------
--------------------------------
--------------------SQS-SS---S--
--S--------SSQSS----------------
--------------------------------
-------------------S----X----Q--
-----------------------XXX------
-----------------------XXX------
-----------X-X---<>----XXX---}--
--{-------XXXXX--[]---XXXX---X--
XXXXX------XXXXXXXXXXXXXXXXXXXXX
