--------------------------------
--------------------------------
--------------------------------
----------S---------------------
--------------------------------
--------------------Q-----------
--------------------------------
--------------------------------
-----------------SSQS-----------
--------------------------------
--------------------------------
-----------<>--<>---<>-------}--
--{---X----[]--[]---[]-------X--
XXXXXXXXXXXXXXXXXXXXXXXXXXXXXXXX
