--------------------------------
--------------------------------
--------------------------------
---------S----------------------
--------------------------------
-------------SQ-------------Q---
--------------------S-----------
--S--S---XX---------------S-----
---------XX---------------------
-------XXXX---------------------
-------XXXX---------------X-----
-------XXXX---XX--<>--<>-XX--}--
--{----XXXX--XXX--[]--[]XXX--X--
XXXXX--XXXXXXXXXXXXXXXXXXXXXXXXX
