--------------------------------
--------------------------------
--------S-----------------------
--------------------------------
--------------------------------
--------------------------------
--------------------------------
----------------------S---------
---------------S----------S-----
---------X---------S------------
--------XXX---------------------
-------XXXX----X------<>--}-----
---{--XXXXX----XX-----[]X-X-----
XXXXXXXXXXXX--XXX---XXXXXXXXXXXX
