--------------------------------
--------------------------------
--------------------------------
-------------SS-----------------
--------------------------------
--------------------SQ--SSS-----
------------SQS-----------------
------Q----------------------S--
--------------------Q-----------
------------>----Q-----X-X------
--------Q--[>----------XXX------
-----------[]-------<>-XXX---}--
--{--------[]-------[]XXXX---X--
XXXXX----XXXXXXXXXXXXXXXXXXXXXXX
