--------------------------------
--------------------------------
----------------------------Q---
-------------------------Q------
------Q-------------------------
-------------S------------------
----------------X---------------
---------------XX------------S--
-------------X-XX--------S------
--------------XXX---------------
-------------XXXX---------------
------<>-<>-XXXXX-X------<>-----
--{---[]-[]XXXXXXXX---X--[]-----
XXXXXXXXXXXXXXXXXXX--XXXXXXXXXXX
