--------------------------------
--------------------------------
--------------------------------
--------------------------------
--------------------------------
--------Q--Q---S-Q-------S---Q--
-------------------S------------
--------------------------------
--------------S-----------------
--------------------------------
-----Q--S---------<>--XX--------
-------------XX---[]--XXX----}--
--{----------XX---[]--XXXX---X--
XXXXX----XXXXXXXXXXXXXXXXXXXXXXX
