--------------------------------
--------------------------------
--------------------------------
--------------------------------
----------------SS--S-----------
--------------------------------
--------------------------------
-------------------------SQS----
----SSQS------------------------
--------------------------------
------------Q-------------------
-----<>-X------<>---}----X---}--
--{--[]XX------[]---X----X---X--
XXXXXXXXX----XXXXXXXXXXXX--XXXXX
