--------------------------------
--------------------------------
--------------------------------
--------------------------------
--------------------------------
--------------------------------
--------------------------------
--------S-----------------------
----Q-----------------S---------
--------------------------------
--------------------------------
-----<>-X----<>-----<>-------}--
--{--[]XX----[]-----[]-------X--
XXXXXXXXX--XXXXXXXXXXXXXX--XXXXX
