--------------------------------
--------------------------------
----------------------------Q---
----Q---------------------------
--------------------------------
-------------SQ-----------------
---QSS----S-----S---------------
----------------------Q---------
------------------S-------------
--------------------------------
--------------------XX----------
---------<>--<>-----XXX---}-----
-----{---[]--[]-----XXXX--X-----
XXXXXXXXXXXXXXXXX----XXXXXXXXXXX
