--------------------------------
--------------------------------
--------------------------Q-----
--------------------------------
--------------------------------
--------------------------S-----
-----------------Q--------------
-----------------------------Q--
--------------------------Q-----
--------------------------------
------------X------XX-----------
-----------XX--<>-XXXX----}-----
-----{----XXX--[]XXXXXX---XX----
XXXXXXXXXXXXXXXXXXXXXXXXXXXXXXXX
