--------------------------------
--------------------------------
--------------------------------
----------S----------------S----
----------------SQ--S-----------
--------------------------------
--------------------------------
---------------S------------S---
--------------------SQSQ--------
--------------------------------
----------X---------------------
------<>-XX----<>------------}--
---{--[]XXX----[]------------X--
XXXXXXXXXX---XXXXXX--------XXXXX
