--------------------------------
--------------------------------
--------------------------------
--------------------------------
--------------S-----------------
--------------------------------
--------------------------------
----------------------SQ--------
-----SSSSS----------------------
--------------------------------
--------------------------------
--------->-X---<>---}-----------
-----{--[]XXX--[]---XX------X---
XXXXXXXXXXXXXXXXXXXXXXX----XXXXX
META {"type": "geom", "shape": "path", "group": "path", "data": [[12, 5, 12, 6], [12, 6, 12, 7], [12, 7, 9, 10], [9, 10, 10, 11], [10, 11, 10, 12], [10, 12, 11, 13], [11, 13, 12, 13], [12, 13, 10, 15], [10, 15, 10, 16], [10, 16, 10, 17], [10, 17, 11, 18], [11, 18, 12, 19], [12, 19, 11, 20]]}
