--------------------------------
--------------------------------
--------------------------------
--------------------------------
------Q-------------------------
--------------------------S-----
--------------------------------
---------------------S-------S--
----------------X-------S-------
----------------XX--------------
-------------X--XXX-------------
------<>----XX--XXXX------}-----
--{---[]---XXX--XXXXX-----X-----
XXXXXXXXXXXXXX--XXXXX--XXXXXXXXX
