--------------------------------
--------------------------------
--------------------------------
--------------------------------
--------------------------------
--------------------------------
--------------------------------
---------S---------S------------
----S---------------------------
------------------------SS------
--------------------------------
-----<>---<----<>--}---------}--
--{--[]---[----[]--X---------X--
XXXXXXXXXXX--XXXXXXXXXX----XXXXX
