--------------------------------
--------------------------------
--------------------------Q-Q---
--------------------------------
---------------------Q----------
--------------------------S-----
-------------Q-QSQ--------------
---------------------S-------Q--
--------------------------------
------------X-------------------
-----------XXX-----X---------Q--
----------XXXX--->-XX-----}-----
-----{---XXXXX--XXXXXX----X-----
XXXXXXXXXXXXXXXXXXXXXXXXXXXXXXXX
