--------------------------------
--------------------------------
--------------------------------
--------------------------------
--------------------------------
--------------------------------
--------------------------------
-------------------X------------
--------SSS--------XX-----------
-------------------XXX----------
------------X------XXXX---------
--------<>-XX--<>--XXXXX---}----
----{---[]XXX--[]--XXXXXX--X----
XXXXXXXXXXXXXXXXXXXXXXXXXXXXXXXX
