--------------------------------
--------------------------------
--------------------------------
--------------------------------
----------------SS--------------
--------------------------------
--------------------------------
---------------------------S----
------SSQ--------------S--------
--------------------------------
--------------------------------
------<>-X-----<>------------}--
---{--[]XX-----[]------------X--
XXXXXXXXXX---XXXXXXXXXX---XXXXXX
