--------------------------------
--------------------------------
--------------------------------
--------------------------------
--------------------------------
--------------------------------
--------------------------------
--------------------------------
--------------------------------
------------------------S-------
--------------------------------
-----<>--------<>--}---------}--
--{--[]--------[]--X---------X--
XXXXXXXXXXXXXXXXXXXXXX-----XXXXX
