--------------------------------
--------------------------------
--------------------------------
--------------------------------
---------------S----------------
--------------------------------
--------------------------------
--------------------------------
--------------------------------
------------------------S-------
--------------------------------
------<>--->---<>------------}--
--{---[]---{---[]------------X--
XXXXXXXXXXXXXXXXXXXXXXXX---XXXXX
