--------------------------------
--------------------------------
--------------------------------
--------------------------------
--------------SS----------------
--------------------------------
--------------------------------
--------------------------------
--------------------------------
--------------------------------
--------------------------------
-----<>--------<>--<>-------}---
--{--[]--------[]--[]----X--X---
XXXXXXXXXXXXXXXXXXXXXXXXXXXXXXXX
