--------------------------------
--------------------------------
--------------------------------
--------------------------------
------Q------------Q------------
--------------------------------
--------------------------------
-----------------Q--------------
--------------------------------
--------------------------------
--------------------------S-----
------<>--<>--XX------<>-----}--
--{---[]--[]--XX------[]-----X--
XXXXXXXXXXXXXXXXX-X-XXXXXXXXXXXX
