--------------------------------
--------------------------------
---------------------Q----------
--------------------------------
------------Q-SS----------------
----Q---------------------------
--------------------------------
----------------------SQ--------
------------S---Q-----------QS--
--------------------------------
-------------------------Q------
-----<>----<>--<>--<>-------}---
--{--[]----[]--[]--[]X------X---
XXXXXXXXXXXXXXXXXXXXXXXX--XXXXXX
