--------------------------------
--------------------------------
--------------------------------
--------------------------------
--------------SS----------------
------------------S-S-----------
--------------------------------
--------------------------------
------SQ---------Q--------------
--------------------------------
--------------------------------
-----<>--------<>--<>-------}---
--{--[]---X----[]--[]-------X---
XXXXXXXXXXXXXXXXXXXXXXXXXXXXXXXX
