--------------------------------
--------------------------------
--------------------------------
--------------------------------
--------------------------------
--------------------------------
--------------------------------
--------------------SQ-Q--------
-----SSSSS-------Q--------------
--------------------------------
------------X----------S--------
-----------XX--<>---}------}----
----{-----XXX--[]---X------X----
XXXXXXXXXXXXXXXXXXXXXXX-XXXXXXXX
