--------------------------------
--------------------------------
------------------S-------------
---------------------------S-S--
----------------S---S-----------
--------------------S-----------
--------------------------------
--------------------------SQ----
---------X----------S-S---------
--------XX----------------X-----
-------XXX---------------XX-----
-----XXXXX----<>--------XXX--}--
--{--XXXXX----[]-------XXXX--X--
XXXXXXXXXXXXXXXXXXXXXXXXXXXXXXXX
