--------------------------------
--------------------------------
--------------------------------
--------------------------------
--------------------------------
--------------------------------
--------------------S-----------
------S-------------------------
--S-----------------------------
--------------------------------
------<>--<>-------<>-----------
------[]---]-------[]---X---}---
---{--[]--[]-------[]---XX------
XXXXXXXXXXXXXXXXXXXXXXXXX-XXXXXX
