--------------------------------
--------------------------------
--------------------------------
---------------------------S----
--------------------------------
--------------------------------
--------------------------------
--------------------------------
---------------SS---------------
----------XX-----------XX-------
----------XX---------XXXX-------
------>--XXX--X>-----XXXX---}}--
-----[]XXXX---X]---XXXXXX---XX--
XXXXXXXXXXXXXXXXXXXXXXXXXXXXXXXX
