--------------------------------
--------------------------------
--------------------------------
--------------------------------
--------------------------------
--------------------------------
--------------------------------
--------------------------------
-------------S------------------
--------------------------------
---------Q------X----<>---------
-----[]------>XXXX---[]------}--
--{--[]-----XXXXXXX--[]---X--X--
XXXXXXXXXXXXXXXXXXXXXXXXXXXXXXXX
