--------------------------------
--------------------------------
--------------------------------
--------------------------------
--------------------S-----------
--------S-----------------------
--------------------------------
---------------------------QS---
--------------------------------
--Q------X--------------X-------
---------Q>---XX--------X-------
------>------XXX----XXXXXX---}--
--{--[]--[]-XXXX---XXXXXXX---X--
XXXXXXXXXXXXXXXXXXXXXXXXXXXXXXXX
