--------------------------------
--------------------------------
--------------------------------
--------------------------------
--------------------------------
---------------------S----------
--------------------------------
--------------------------------
--------------------------------
--------------------------------
----------X-X--X------<>--------
------>--XX---XX------[]---}----
--{--[]XXXX-XXXX------[]---X----
XXXXXXXXXXXXXXXXX-XXXXXXXXXXXXXX
