--------------------------------
--------------------------------
--------------------------------
--------------------------------
--------------------------------
--------------------------------
--------------------------------
--------------------------------
--------------------------------
--------------------------------
--------<>------------<---------
--------[]--<>---XX--[]]--------
--{-{---[]--[]--XXX---[]-----X--
XXXXXXXXXXXXXXXXXXXXXXXXX--XXXXX
