--------------------------------
--------------------------------
--------------------------------
--------------------------------
--------------------------------
---------------------SSS--------
-------S------------------------
-----------------Q--------------
-------------S------------------
---Q----------------------------
--------<>------X-----<>--------
--------[]----XXX-----[]--------
----{---[]---XXXX-----[]--------
XXXXXXXXXXXXXXXXX--XXXXXXXXXXXXX
