--------------------------------
--------------------------------
--------------------------------
--------------------------------
--------------------------------
--------------------------------
--------------------------------
---------------------SS---------
--------------------------------
-----------------XX-------------
----------------XXX---<>--------
------------<>--XXX---[]---}----
--{---------[]-XXXX---[]---X----
XXXXXXXXXXXXXXXXXXXXXXXXXXXXXXXX
