--------------------------------
--------------------------------
--------------------------------
--------------------------------
--------------------------------
--------------------------------
------S-------------------------
---------S-----------SS---------
--------------------------------
-----------------XX-------------
-----<>---------XXX---<>--------
-----[]-----<>-XXXX---[]--------
--{--[]-----[]XXXXX---[]---X----
XXXXXXXXXXXXXXXXXXXXXXXXXXXXXXXX
