--------------------------------
--------------------------------
--------------------------------
--------------------------------
--------------------------------
---------------------QS---------
--------------------------------
-----------------Q--------------
-------------S------S-----------
---SSS--------------------------
--------<>------X-----<>--------
--------[>-----XX-----[]--------
----{---[]----XXX-----[]--------
XXXXXXXXXXXXXXXXX--XXXXXXXXXXXXX
