--------------------------------
--------------------------------
--------------------------------
--------------------------------
---------------SS---------------
--------------------------------
------------------------S-------
----------S---SQ---SS-----------
---------------------------SS---
--------------------------------
-----------<>-------------------
-----------[]>---X-----------}--
--{--{-----[]----XX----------X--
XXXXXXXXXXXXXXXXXXXX-XXX-XXXXXXX
