--------------------------------
--------------------------------
--------------------------------
--------------------------------
--------------------------------
---------------------Q----------
------SS------------------------
--------------------------------
-------------S------------------
----------------XXX-------------
--------<>------XXX---<>--------
--------[]-----XXXX---[]--}--}--
--{-----[]---]XXXXX---[]--X--X--
XXXXXXXXXXXXXXXXXXXXXXXXXXXXXXXX
