--------------------------------
--------------------------------
--------------------------------
--------------------------------
---------------------S----------
--------------------------------
--------------------------------
--------------------------------
--S-----------------------S-----
--------------------------------
------<>--X>---------XX-X-------
------[>--[X--------XX-------}--
---{--[]--[]---X---XXX--X----X--
XXXXXXXXXXXXXXXXXXXXXX-XXXXXXXXX
