--------------------------------
--------------------------------
--------------------------------
---S---------Q--S---------------
--------------------------------
-------SS-----------Q--QS-------
--------------------------------
--------------------------------
----S----------X----------------
--Q-----------XXX---------------
------------XXXX------X---------
------>---X-XXXXX----XX----}----
--{--[]X-X-XXXXXX----[XX---X----
XXXXXXXXXXXXXXXXXXXXXXXXXX-XXXXX
