--------------------------------
--------------------------------
--------------------------------
--------------------------------
--------------------------------
--------------------------------
--------------------------------
--------------------------------
--------------------------------
---SSS--------------------------
--------->----------------------
--------[]----<>-------------}--
----{---[]----[]-----XX------X--
XXXXXXXXXXXXXXXXXXXXXXXXXXXXXXXX
