--------------------------------
--------------------------------
--------------------------------
--------------------------------
--------------------------------
--------------------------------
--------------------------------
---------------------SS---------
-------------S------------------
-----------------XX-------------
--------<>------XXX--<>---------
--------[---<>-XXXX--[]---}--}--
--{-----[]--[]XXXXX--[]---X--X--
XXXXXXXXXXXXXXXXXXXXXXXXXXXXXXXX
