--------------------------------
--------------------------------
--------------------------------
--------------------------------
--------------------------------
--------------------------------
--------------------------------
--------------------------------
--------------------------------
--------------------------------
--------<>------X---------------
--------[]-----XXX---X----}--}--
--------[]----XXXXX--XX---X--X--
XXXXXXXXXXXXXXXXXXX--XXXXXXXXXXX
