--------------------------------
--------------------------------
--------------------------------
--------------------------------
--------------------------------
--------------------------S-----
-------------------SSS----------
---------------S----------S-----
------------------------Q-------
--------------------------------
----------<>-------->-----------
------<>--[]-------[>---X---}---
---{--[]--[]-------[]---XX--X---
XXXXXXXXXXXXXXXXXXXXXXX-XXXXXXXX
