--------------------------------
--------------------------------
--------------------------------
--------------------------------
----------SSQ--SSS--------------
--------------------------------
------S-----------------Q-------
---------SS----Q----SSS---------
---------------------------SS---
--------------------------------
------>----------XX--S>S--------
-----[]-----<>---XX--[]----}----
--{--{]-----[]---XX--------X----
XXXXXXXXXXXXXXXXXXXXXXXXX--XXXXX
