--------------------------------
--------------------------------
--------------------------------
---------------------------S----
--------------------------------
--------------------------------
--------------------------------
--------------------------------
--------------------------S-----
--------------------------------
-----<>--------------XX---------
-----[]-------XX----XXX------}--
--{--[]--[]--XXX---XXXX------X--
XXXXXXXXXXXXXXXXXXXXXXX-XXXXXXXX
