--------------------------------
--------------------------------
--------------------------------
--------------------------------
--------------------------------
--------------------------------
--------------------------------
--------------------------------
--S-----------------------------
--------------------------------
----------<>--------------------
------<>--[]----XX----<>----}---
---{--[]--[]----XX----[]----X---
XXXXXXXXXXXXXXXXXXXXXXXXXXXXXXXX
