--------------------------------
--------------------------------
--------------------------------
--------------------------------
--------------------------------
--------------------------------
--------------------------------
--------------------------------
--------------------------------
--------------------------------
----------<>--------------------
------<>--[]-------[]-----------
---{--[]--[]-------[]--XX-------
XXXXXXXXXXXXXXXXXXXXXXXXXXXXXXXX
