--------------------------------
--------------------------------
--------------------------------
--------------------------------
--------------------------------
--------------------------------
--------------------------------
--------------------------------
--------------------------------
---SSSS-------------------------
--------<>----------------------
--------[]----<>-X----<>--}--}--
--------[]----[]XXX---[]--X--X--
XXXXX---XXXXXXXXXX---XXXXXXXXXXX
