--------------------------------
--------------------------------
--------------------------------
--------------------------------
--------------------------------
--------------------------S-----
-------------------SSS----------
---------------SS---------S-S---
-----------------------------S--
--------------------------------
----------<>-------<>-----------
------<>--[]--<>---[]--XX---}---
---{--[]--[]--[]---[]--XXX--X---
XXXXXXXXXXXXXXXXXXXXXXXXXXXXXXXX
