--------------------------------
--------------------------------
--------------------------------
--------------------------------
--------------------------------
--------------------------------
--------------------SS----------
--------------------------S-----
--S---SQ------------------------
--------------------------------
----------X>--------------------
------<>-X[X--<>---[>--XX---}---
---{--[]XXX]--[]---[]--XXX--X---
XXXXXXXXXXXXXXXXXXXXXXXXXXXXXXXX
