--------------------------------
--------------------------------
--------------------------------
--------------------------------
--------------------------------
--------------------S-----------
--------------------------------
--------------------------------
------------X---X---------------
---S------XX---XX---------------
---------XX-X--XX---------------
---------XX-X--XXX---->X--}--}--
-------XXXX-XXXXXX---XXX--X--X--
XXXXXXXXXXXXXXXXXXXXXXXXXXXXXXXX
