--------------------------------
--------------------------------
--------------------------------
--------------------------------
--------------------------------
--------------------------------
------SS------------------------
-----------------Q--------------
-------------S------------------
--------------------------------
--------<>------------<>--------
--------[]--<>-X------[]--------
--{-{---[]--[]XXX-----[]--------
XXXXXXXXXXXXXXXXX--XXXXXXXXXXXXX
