--------------------------------
--------------------------------
--------------------------------
--------------------------------
--------------------------------
----------------------SQ--Q-----
--------------------------------
--------------------------------
--------------------------------
---------Q----X-----------------
-----<>------X--X---------------
-----[]-----XX----------XX---}--
--{--[]-----XXX-XXXX---XXX---X--
XXXXXXXXXXXXXXXXXXXXXX-XXXXXXXXX
