--------------------------------
--------------------------------
--------------------------------
-----------------S--------------
--------------------------------
--------------Q------S----------
--------------------------------
--------------------------------
-------------SS-------SQ-----S--
--------------------------------
--------------------------------
--------<>--<>--XX---<>------}--
-----{--[]--[]--XXX--[]XX----X--
XXXXXXXXXXXXXXXXXXXXXXXXX--XXXXX
