--------------------------------
--------------------------------
-------------------S------------
-------------------------SSSQQ--
--------------------------------
------S-------------------------
--------------------S-----SQ----
---SQ--S---------------------Q--
--------------------------------
-------------------------S------
-----S---------X---<>-----------
-----------<>-XX---[]-------}---
--{--------[]XXXX--[]-------X---
XXXXXX--XXXXXXXXXXXXXXXXXXXXXXXX
