--------------------------------
--------------------------------
--------------------------------
--------------------------------
---------------S----------------
--------------------------------
--------------------------------
---------------------------S----
--------------------------------
--------------------------------
--------------<>-------X--------
----------<>--[]------XX--}-----
--{--{----[]--[]-X---XXX--X-----
XXXXXX-XXXXXXXXXXXXXXXXXXXXXXXXX
