--------------------------------
--------------------------------
--------------------------------
--------------------------------
-------------Q-SSS--------------
--------------------------------
--------------------------------
--------------S--Q--------------
-----------------------S-SQS----
-----------------------------S--
--------------X-----------------
-------------<>-XX----<>--}-----
--{--{-------[]XXX----[]--X-----
XXXXXXXXX--XXXXXXX--XXXXXXXXXXXX
