--------------------------------
--------------------------------
------------------------SQ------
--------------------------------
-------S--------------------S---
-------------------------SS-----
-------Q--SQ---S----------------
--------------------------------
------------------S---Q---------
-----------SQ-------------------
------------------Q-------------
------XXX-------------<>-----}--
--{---XXX-------------[]-----X--
XXXXXXXX------------------------
