--------------------------------
--------------------------------
--------------------------------
--------------------------------
---------------SSSQ-------------
--------------------------------
--------------------------------
--------------S--Q--------------
-------------------------S------
--------------------------------
--------------X-----------------
-----<>------<>-------<>-XX--}--
--{--[]------[]XXX----[]XXX--X--
XXXXXXXXX--XXXXXXX--XXXXXXXXXXXX
