--------------------------------
--------------------------------
----------------SS--------------
--------------------------------
--------------------------------
--------------------Q-----------
--------------------------------
--Q-----S---------------X---S---
-----------------------XX-------
-----------------------XX-------
----------XX----------XXX-------
-----<>--XXXX---<>---XXXX----}--
--{--[]--XXXX---[]--XXXXX----X--
XXXXXXXXXXXXXXXXXXXXXXXXXXXXXXXX
