--------------------------------
--------------------------------
---------------S----------------
--------------------------------
-------------------------Q------
--------------------Q----X------
------------------------X-------
--------SS-----SQ------XX--SS---
----------------------XXX-------
----------------------XXX-------
---------------------XXXX-------
--------<>-X--<>----XXXXXXX--}--
---{----[]XX--[]--XXXXXXXXX--X--
XXXXXXXXXXXXXXXXXXXXXXXXXXXXXXXX
