--------------------------------
--------------------------------
--------------------------------
--------------------------------
--------------------------------
--------------------------------
----------------------S--SQ-----
---SQSSS--------Q-----X---------
---------------------XX---------
--------------------XXX---------
-------------------XXX----------
----------<>---X--XXXXX----}----
--{-------[]---XX-XXXXX----X----
XXXXXX--XXXXXXXXXXXXXXXXXXXXXXXX
