--------------------------------
--------------------------------
--------------------------------
--------------------------------
--------------------------------
--S-----------------------------
-----S--------------------------
-----------------Q--------------
--------------------------SQ----
--------------XX----------------
-------------XXXX---------------
-----<>-----XXXXX----<>------}--
--{--[]-----XXXXXXX--[]------X--
XXXXXXXXXXXXXXXXXX--XXXXXXXXXXXX
