--------------------------------
--------------------------------
--------------------------------
---------------------------S----
---Q----------------------------
------S-------------------------
--------------------S-SSQSSQS---
------S---------Q---------------
--------------------------------
---------------SQ---------------
------<>---<>------<>-----------
------[]---[]------[]------}----
--{---[]---[]------[]------X----
XXXXXXXXXXXXXXXXXXXXXXXXXXXXXXXX
