--------------------------------
--------------------------------
--------------------------------
--------------------------------
--------------------------------
--------------------------------
--------------------------------
--------------------------------
--------------------------------
--------------------------------
--------------------------------
------------<>--X----<>-----}---
---{--------[]--X----[]-----X---
XXXXXXXXXXXXXXXXXXXXXXXXXXXXXXXX
