--------------------------------
--------------------------------
--------------------S-----------
----------Q---S-----------------
----S---------------Q-----------
-------------------S---Q----SQ--
--------------Q-----------------
--SSQS---S----------S-----Q-----
-----------------------------Q--
--------------------------------
----------------<>--------------
----------<X----[]---<>----}----
-----{----XX----[]---[]----X----
XXXXXXXXXXXXXXXXXXXXXXXXXXXXXXXX
