--------------------------------
--------------------------------
--------------------------------
-----------------S--------------
----S---------------------------
--------------------Q--Q--------
--------------Q---S-------------
-------------------------SQQSS--
--------------------------------
-----------------XX-------------
--------<>-------XX-------------
--------[]------XXX--<>---------
----{---[]-----XXXX--[]X--------
XXXXXXXXXXXXXXXXXXXXXXXXXXXXXXXX
