--------------------------------
--------------------------------
--------------------------------
--------------------------------
----SS--------------Q-----------
-------------------S---Q--------
--------------Q-----------------
----S---------------------S-----
--------------------X-----------
--------------------XX----------
--------<>-----X--X-XXX---------
--------[]->---X-XX-XXX---------
----{---[]-]---XXX--XXX---------
XXXXXXXXXXXXXXXXXXXXXXXXXXXXXXXX
