--------------------------------
--------------------------------
--------------------------------
--------------------------------
---------------------------SS---
--------------------------------
--------------------------------
--------------------------------
--------------------------------
--------------------------------
------------------S-SQ----------
------XX----<>---------------}--
---{--XX----[]---------------X--
XXXXXXXXX-XXXXXXX-X---------XXXX
