--------------------------------
--------------------------------
-------------SSQ----------------
--------------------------------
---------------------S---Q------
---SS---------------------------
------------------------X-------
------------------------X--SS---
-----------------------XX-------
--S-------XX----------XXX-------
---------XXX---------XXXX-------
-----<>---XX--------XXXXXXX--}--
--{--[]--XXX------XXXXXXXXX--X--
XXXXXXXXXXXXX-XXXXXXXXXXXXXXXXXX
