--------------------------------
--------------------------------
--------------------------------
--------------------------------
--------------------------------
--S-----------------------------
--------------------------------
---------------------------S----
--------------------------------
-----------------------------S--
--------------XX------<Q--------
-----<>---<>-XXX------[]--}-----
--{--[]---[]XXXX------XX--X-----
XXXXXXXXXXXXXXXXXXXXXXXXXXXXXXXX
