--------------------------------
--------------------------------
--------------------------------
--------------------------------
--------------------------------
--------------------------------
--------------------------------
--------------------------------
--------------------------------
--------------------------------
------------------------X-------
-----<>------<>-------XXXX---}--
--{--[]------[]-------XXXX---X--
XXXXXXXXXXXXXXXXXXXXXXXXXXXXXXXX
