--------------------------------
--------------------------------
--------------------------------
--------------------------------
--------------------------------
-------S------------------------
--------------------------------
--------------------------------
-----------------S--------------
--------------------------------
--------------------------X-----
------<>------X-------<>-XX--}--
--{---[]-----XXX------[]XXX--X--
XXXXXXXXXXXXXXXX--XXXXXXXXXXXXXX
