--------------------------------
--------------------------------
--------------------------------
------------Q-------------------
---Q----------------------------
--------------------------------
-----------SQ------------SQ-----
--SSQSS---------Q---------------
--------------------XX----------
-------------------XXX--S-------
-----SS------------XXX----------
----------<>---X--XXXXX----}----
--{-------[]---XX-XXXXX----X----
XXXXXXXXXXXXX---XXXXXXXXXXXXXXXX
