--------------------------------
--------------------------------
--------------------------------
--------------------------------
--------------------------------
--------------------------S-----
----------------S---------------
---------------------SQ------S--
--------S-----------------------
----------------X---------------
-------------X--X---------------
-----<>--<>-XX--XXXX---------}--
-----[]--[]XXX--XXXX---------X--
XXXXXXXXXXXXXX--XXXX-------XXXXX
