--------------------------------
--------------------------------
--------------------------------
---------------Q----------------
------Q------------Q------------
--------------------------------
--------------------------------
--------------------------------
--------------------------------
---Q----------------------------
------<>------X--X--------------
------[]--<>--XX-XX---<>-----}--
---{--[]--[]--XX-XXX--[]-----X--
XXXXXXXXXXXXXXXX-XXXXXXXXXXXXXXX
