--------------------------------
--------------------------------
--------------------------------
---------------S----------------
--------Q--S--------------------
--------------------------------
--------------------------------
--------S-----------------------
--------------------------------
--------------X-----------------
--------------XX----<>----------
-----<>--<>----XX---[]----}-----
--{--[]--[]---XXXX--[]----X-----
XXXXXXXXXXXXX--XXXXXXXXXXXXXXXXX
