--------------------------------
--------------------------------
--------------------------------
---------------S----------------
--------------------------------
--------------------------------
------------------Q-------------
--------SS------------------S---
--------------------------------
--------------------------------
------<>--------<>--------------
------<>--------[]--------------
--{---[]--------[]--------------
XXXXXXXXXXX---XXXXXXX------XXXXX
