--------------------------------
--------------------------------
--------------------------------
--------S-S---------------------
--------------------------------
------------S-Q-----------------
----------S-----S---------------
---SQQS---------------Q---------
------------------SQ-QS---Q-----
----------XX--------------------
---------XXX--------------------
--------XXXX--<>-----X---<>-----
----{--XXXXX--[]----XX---[]-----
X--XXXXXXXXXXXXXXX--XX--XXXXXXXX
