--------------------------------
--------------------------------
--------------------------------
--S-SQS-------------------------
--------------------------------
--------------------S-----------
--------------------------------
--------------------------SQ----
----------------------S---------
--------------------------X-----
------------------------XXX-----
-----<>-X-----<>----<>-XXXX--}--
--{--[]XX-----[]----[]-XXXX--X--
XXXXXXXXX--XXXXXXXXXXXXXXXXXXXXX
