--------------------------------
--------------------------------
--------------------------------
--------------------------------
-----------------SQ-------------
--------------------------------
-------------Q------------------
--------------------SQ---Q------
--------------------------------
--------------------------------
------------X---------SQS-------
-----<>---XXX--<>---}-------}---
--{--[]--XXXX--[]---X-------X---
XXXXXXXXXXXXXXXXXXXXXX---XXXXXXX
