--------------------------------
--------------------------------
--------------------------------
---------------------------S-S--
---------------QSQ--------------
--------------------------------
--------------------------------
-------------------------SSQ----
----SSQQ---------------S--------
--------------------------------
-------------------------XX-----
------XXX------<>-------XXX--}--
--{--XXXX------[]-------XXX--X--
XXXXXXXXX----XXXXXXXXXXXXXXXXXXX
