--------------------------------
--------------------------------
--------------------------------
--------------------------------
--------------------------------
--------------------------------
--S--------------------S--SQ----
----------SSSSQS--S-------------
--------------------------------
---S----------------------------
--------------------------------
----------<>----------<>-----}--
--{--XX---[]---X------[]-----X--
XXXXXX---XXXXXXXXXXXXXXXXXXXXXXX
