--------------------------------
--------------------------------
--------------------------------
----------S---------------------
--------------------------------
--------------------------------
--------------------------------
--------------------------------
------------------SSS-SQ--------
----------X---------------------
---------XX---------------------
-----<>-XXX---<>--<>-X---XX--}--
-----[]XXXX---[]--[]-X---XX--X--
XXXXXXXXXXXXXXXXXXXXXX---XXXXXXX
