--------------------------------
--------------------------------
--------------------------------
--------------------------------
---------------QS---------------
--S--QSQ------------------------
------------S-----------Q----S--
--S-----------------------------
-----SQQ-S---------S---S---S-S--
--------------------------------
-------------------<>-----------
-------------------[]--------}--
--{--XX------------[]--------X--
XXXXXXX--------XXXXXXXXX---XXXXX
