--------------------------------
--------------------------------
--------------------------------
--------------------------------
--------------------------------
--------------------------------
--------------------------------
--------------------------------
--------S--S--------------------
--------------------------------
--------------------------------
-----<>--<>--<>---<>--XX-----}--
--{--[]--[]--[]---[]-XXX-----X--
XXXXXXXXXXXXXXXXXXXXXXXXXXXXXXXX
