--------------------------------
--------------------------------
----------------------------Q---
-----------------S--------------
---------------------Q----------
-------------S------------------
----------------S-Q-------------
--------------------------------
---------------XX--------S------
--------------XXX---------------
-------------X-XX---->----------
-----<>--<>-XX-XX---[]----}-----
--{--[]--[]XXX-XXX--[]----X-----
XXXXXXXXXXXXXXXXXXXXXXXXXXXXXXXX
