--------------------------------
--------------------------------
--------------------------------
----------Q---------------------
--------------------------------
-----------------------S--------
--------------------------------
---------------S--S-------------
---------------------S----------
--------------------------S-----
-----------------S--------S-----
------<>-----<>--------------}--
---{--[]-----[]--------------X--
XXXXXXXXXX---XXXX-------XXXXXXXX
