--------------------------------
--------------------------------
--------------------------------
-----S--------------------------
--S-----Q-----------------------
--------------------------------
--------------------------------
----------SQSQ---Q--------------
--------------------------------
-----XX------------------X------
-----XX-----------------XX------
-----XX------XX-----<>-XXX------
--{--XX------XXX----[]XXXX---X--
XXXXXXXXX----XXXX-XXXXXXXXXXXXXX
