--------------------------------
--------------------------------
--------------------------------
--------Q-----------------------
--------------------------------
--------------------------------
--------------------------------
--------------------------------
-----S---SS---------------S-----
--------------------------------
---------------------XX---------
--------->XX---<>---XXXX---}----
----{---[XXXX--[]--XXXXX---X----
XXXXXXXXXXXXXXXXXXXXXXXXXXXXXXXX
