--------------------------------
--------------------------------
----------------------------Q---
-----------------S--------------
--------------------------------
-------------S------------------
-----------------SQ-------------
------S----------Q--------------
-------------X-X---------S------
-------------XXX----------------
-------------XXX----------------
------<>-XX--XXXX---Q----<>-----
--{---[]-XX--XXXXX-------[]-----
XXXXXXXXXXXXXXXXXXX----XXXXXXX--
