--------------------------------
--------------------------------
--------------------------------
--------------------------------
--------------------------------
--------------------------------
--------------------------------
--------------------------------
------SQ------------------------
--------------------------------
-------------------------S------
-----<>--------<>--<>------}----
--{--[]--------[]---]X-----X----
XXXXXXXXX--XXXXXXXXXXXX---XXXXXX
