--------------------------------
--------------------------------
--------------------------------
----------Q---------------------
--------------------------------
--------------------------------
--------------------------S-----
-------------SQS--S-------------
---------------------S----------
---S----------------------S-----
-----------------S--------------
----------<>----------<>-----}--
---{------[]----------[]-----X--
XXXXXXXXXXXXXXXXXX--XXXXXXXXXXXX
