--------------------------------
--------------------------------
--------------------------------
----------S---------------------
--------------------------------
--------------------------------
--------------------------------
--------------------------------
-------S------------S-----------
--------------------------------
--------------------------------
------<>-X----<>--<>-X-------}--
---{--[]XX----[]--[]-X-------X--
XXXXXXXXXX--XXXXXXX-X----XXXXXXX
