--------------------------------
--------------------------------
--------------------------------
----------Q---------------------
--------------------------------
-----------------------S--------
--------------------------------
------------------Q-------------
---------------------S----------
--------------------------------
--------------------------------
----------<>--<-------<>-----}--
---{------[]--[]------[]-----X--
XXXXXX--XXXXXXXXXX-----XXXXXXXXX
