--------------------------------
--------------------------------
--------------------------------
--------------------------------
--------------------------------
--------------------------------
--------------------------------
--------------------------------
-------SQ----S------------------
--------------------------------
--------------------------------
-----<>--<>----<>--X>--<>----}--
--{--[]--[]----[]XXX]--[]----X--
XXXXXXXXXXXXXXXXXXXXXXXXXXXXXXXX
