--------------------------------
--------------------------------
--------------------------------
---------------S----------------
-----Q------------------SS------
-------SQ--S--------S-----------
--------------------------------
--------------------------------
-----------Q--------------------
--------------------------------
--------------------------------
------<>--------<>--<>-----}----
---{--[]--------[]--[]-----X----
XXXXXXXXXXXXXXXXXXXXXXXXXXXXXXXX
