--------------------------------
--------------------------------
--------------------------------
--------------------------------
--------------------------------
--------------------------------
--------------------------------
--------------------------------
-------SS-S-------SS------------
--------------------------------
--------------------------------
-----<>---<>-XX--------<>--}----
--{--[]---[]XXX--------[]--X----
XXXXXXXXXXXXXXXXXXXXXXXXXXXXXXXX
