--------------------------------
--------------------------------
--------------------------------
----------------------------SS--
----Q---------------------------
---SSSQ-S-----S-----------------
-------------------------SS-SS--
--------------------------------
------SSSQS--------X------------
------------------XXX-----------
-----------------XXXX-----------
-------<>----<>-XXXXX-------}---
--{----[]----[]XXXXXX-------X---
XXXXXXXXXXXXXXXXXXXXXXXXXXXXXXXX
