--------------------------------
--------------------------------
--------------------------------
--------------------------------
--------------------------------
--------------------------------
--------------------------------
----------------SS-S------------
--------------------------------
--------------------------------
-----------------------XX-------
---------<>----<>--<>--XX----}--
---------[]----[]--[]--XX----X--
XXX---XXXXXXXXXXXXXXXXXXXXXXXXXX
