--------------------------------
--------------------------------
--------------------------------
--------------------------------
--------------------------------
--------------------------------
--------------------------------
--------------------------------
--------------------------------
--------------------------------
--------------------------------
-----<>--<>-------<>---<>---}---
--{--[]--[]-------[]---[]---X---
XXXXXXXXXXXXXXXXXXXXXXXXXXXXXXXX
