--------------------------------
--------------------------------
--------------------------------
--------------------------------
--------------------------------
--------------------------------
--------------------------------
--------------------------------
--------------------------------
--------------------------------
--------------------------------
------<>--<>-X---------<>--}----
--{---[]--[]XX---------[]--X----
XXXXXXXXXXXXXXXXXXXXXXXXXXXXXXXX
