--------------------------------
--------------------------------
--------------------------------
--------------------------------
---------------------------QQ---
--------------------------------
--------------------------------
--------------------------------
-----------------SS-------------
--------------------------------
--------------------------------
-----<>---<>------<>---<>---}---
--{--[]---[]--X---[]---[]---X---
XXXXXXXXXXXXXXXXXXXXXXXXXXXXXXXX
