--------------------------------
--------------------------------
--------------------------------
-------------S-SS---------------
-----SS--------------S--SS-SQ---
-----------------S--S-----------
--------------------------------
-----SS--------------------SQ---
-----------S--------------------
--------------------------------
--------------------------Q-----
------<>--<>--<>----<>-----}----
---{--[]--[]--[]----[]-----X----
XXXXXXXXXXXXXXXXXXXXXXXXXXXXXXXX
