--------------------------------
--------------------------------
--------------------------------
---------------S----------------
-----Q-----------------SSQ------
-------SQ--S--------S-----------
--------------------------------
-----Q-----------------S---SQ---
-----------Q--------Q-----Q-----
--------------------------------
--------------------------------
------<>------<>----<>---XX--}--
---{--[]------[]----[]--XXX--X--
XXXXXXXXXXXXXXXXXXXXXXXXXXXXXXXX
