--------------------------------
--------------------------------
--------------------------------
--------------------------------
--------------------------------
--------------------------------
--------------------------------
--------------------------------
-----------------SS-------------
--------------------------------
--------------X-----------------
-----<>---<>-XX---<>---<>--}----
--{--[]---[]XXX---[]---[]-------
XXXXXXXXXXXXXXXXXXXXXXXXXXXXXXXX
