--------------------------------
--------------------------------
--------------------------------
--------------------------------
--------------------------------
------S------Q------------------
----------------S-----Q---------
--------------------------------
---------S-QS------------XX-----
------------------------XXX-----
----------------------XXXXX-----
-------<>-------<>----XXXXX--}--
----{--[]-X-----[]---XXXXXX--X--
XXXXXXXXXXXXXXXXXXXXXXXXXXXXXXXX
