--------------------------------
--------------------------------
--------------------------------
--------------------------------
-----------------------SQ-------
------SS--SSSQ------S------SS---
--------------------------------
---SQ------------------S---SQS--
-----------Q--------Q---Q-------
--------------------------------
--------------------------------
-------X------<>----X>---XX--}--
---{---X------[]----[X--XXX--X--
XXXXXXXXX--XXXXXXXXXXXXXXXXXXXXX
