--------------------------------
--------------------------------
--------------------------------
--------------------------------
--------------------------------
--------------------------------
--------------------------------
----------------S--S------------
------------S-------------------
--------------------------------
--------------------------------
---------<>----<>--<>--<>----}--
---{{----[]----[]--[]--[]----X--
XXXX-XXXXXXXXXXXXXXXXXXXXXXXXXXX
