--------------------------------
--------------------------------
--------------------------------
---------------S----------------
-----Q--------------S--SQ-------
-------SQ--S--------------------
-----------------Q--------------
--------------------------------
-----------Q--------Q-----Q-----
--------------------------------
------------------------QX------
------<>--------<>--<>-X-XX-----
---{--[]--------[]--[]XXXX------
XXXXXXXXXXXXXXXXXXXXXXXXXXXXXXXX
