--------------------------------
--------------------------------
--------------------------------
--------------------------------
----------------S---------------
------------------QQ--Q---------
--------------------------------
-----Q---Q-----S----------SSS---
--------------------------------
---------------------XX---------
-----SQ--<>----------XXX--------
---------[]---<>-XX--XXXX----}--
-----{---[]---[]XXX--XXXX----X--
XXXXXXXXXXXXXXXXXX---XXXXXXXXXXX
