--------------------------------
--------------------------------
--------------------------------
-------------------------Q------
--------------SSS---------------
--------------------------------
---------S-----------S----------
-----S-----SQ-------------------
--------------------------Q-----
-----------X-------S------------
------<>--XX--------------------
------[]--XX---X----------}-----
---{--[]--XX---XX---------X-----
XXXXXXXXXXXX---XX-------XXXXXXXX
