--------------------------------
--------------------------------
--------------------------------
--------------------------------
--------------------------------
--Q-----------------------------
-----SQ-------------------------
-----S---QQ---------------------
--------------S-----------------
---------XX---------------------
-------XXXX-----------<>--------
-------XXXX-----------[]--}-----
--{----XXXX-----------[]--X-----
XXXXXXXXXXXX--------XXXXXXXXXXXX
