--------------------------------
--------------------------------
--------------------------------
--------------------------------
--------------------------------
-------------S------------------
----------------S---------------
-------S------------------------
--------------S-------X---------
---------------------XXX--------
-----SQ---------------XXX-------
--------------<>--<>--XXXX---}--
--{-----------[]--[]--XXXXX--X--
XXXXX-----XXXXXXXXXX-XXXXXXXXXXX
