--------------------------------
--------------------------------
-------SS-----------------------
--------------------------------
--------------------------------
------Q-------------------------
--------------------------------
-----------XX-------------------
-----------XX-------------------
-----------XX-------------------
---------XXXX-------------------
--------XXXXX-----<>--<>----}---
---{---XXXXXXX----[]--[]----X---
XXXXXXXXXXXXXXXXXXXXXXXXXXXXXXXX
