--------------------------------
--------------------------------
--------S-----------------------
--------------------------Q-----
--------------S-----------------
--S-----------------------------
-----------------S--------------
--S-----------QQ----------------
---------------------S-------Q--
-----S-XX-X------SQSS-----X-----
--------X-X--------------XX-----
-------X---X--X---------XXX--}--
---{------XX--XX-------XXXX--X--
XXXXXXX---XX--XX----XXXXXXXXXXXX
