--------------------------------
--------------------------------
--------------------------------
--------------------------Q-----
--------------------------------
-------------S------------------
--------------------------------
--S--S--------------------SS----
----------------------X---------
----------------------XX--------
-----S----------------XXX-------
----------X---<>-------XXX---}--
--{------XX---[]X-----XXXXX--X--
XXXXX----XXXXXXXXX--XXXXXXXXXXXX
