--------------------------------
--------------------------------
--------------------------------
-------------------------Q------
------------------S-------------
--------------------------------
----------S---------------Q-----
--------------------------------
--S--------------SS-------------
--------------------------------
------<>--------------S---------
------[]------------------}-----
--{---[]------------------X-----
XXXXXXXXXX--------X----XXXXXXXXX
