--------------------------------
--------------------------------
--------------------------------
--------------------------------
----------------S---------------
--------------------------------
--------------------------------
--------------------------------
--------------S-----------------
--------------------------------
--------------------------------
-----------X---<>----XX---}-----
--{-----XXXX---[]X---XX---X-----
XXXXXXXXXXXXXXXXXXX--XXXXXXXXXXX
