--------------------------------
--------------------------------
--------------------------------
--------------------------------
--------------------------------
---------------------------Q----
--------------------------------
------------------S------Q------
---SQS------SQ------------------
--------------------------------
-------------------------S------
-----<>----------<>---------}---
--{--[]----------[]---------X---
XXXXXXXXXXXX---XXXXXXX----XXXXXX
