--------------------------------
--------------------------------
--------------------------------
--------------------------------
--------------------------------
--------------------------------
--------------------------------
--------------X-----------------
---------Q----XX----------------
--------------XXX---------------
-------------XXXXX--------------
---------<>--XXXXXX------X---}--
--{------[]-XXXXXXXX----XXX--X--
XXXXXXXXXXXXXXXXXXXXXXXXXXXXXXXX
