--------------------------------
--------------------------------
----------S---------------------
--------------------------------
--------------------------------
-----------------Q----S------S--
--S--------SS-QS----------------
--------------------------------
-------------------S----X-------
------------------------X-------
-----<>----------------<>-------
-----[]-------X--------[]----}--
--{--[]------XXX---{---[]----X--
XXXXXXXXX--XX-XXXXXXXXXXXXXXXXXX
