--------------------------------
--------------------------------
--------------------------------
---------S----------------------
--S----------------S-------S----
------------S----------------Q--
--------------------------------
---S-------XX---------S---------
-----------XX--S----------S-----
----------XXXX------------------
---------XXXX-------------------
--------XXXXX--X------<>---}----
---{---XXXXXXX--------[]---X----
XXXXXXXXXXXXXXXXXXXXXXXXXXXXXXXX
