--------------------------------
--------------------------------
--------------------------------
--------------------------------
--------------------------------
--------------------------------
--------------------------------
--------------------------------
---------------------X----------
---------------------XX---------
---------------------XXX--------
-----------<>---<>---XXXX---}---
--{--------[]---[----XXXXX--X---
XXXXXXXXXXXXXXXXXXXXXXXXXXXXXXXX
