--------------------------------
--------------------------------
----------S---------------Q--S--
---------S-----S----------------
--------------------Q-----------
------S----------------------S--
--SS---------------------Q------
---S-------XXX------------------
------Q----XXX-X---S------------
----------XXXXXX----------------
---------XXXXXXX----------------
--------X--XXXXX-------<>----}--
----{--XX--XXXXX---{---[]----X--
XXXXXXXXXXXXXXXXXXXXXXXXXXXXXXXX
