--------------------------------
--------------------------------
--------------------------------
---------------S----------------
--------------------------------
--------------------------------
--------------------------------
----------------S---------------
------QS------------------------
--Q-----------XX----------------
-------------XXX-------<>-------
-----<>-----XXXX-------[>----}--
--{--[]----XXXXX---{---[]----X--
XXXXXXXXXXXXXXXXXXXXXXXXXXXXXXXX
