--------------------------------
--------------------------------
--------------------------------
---------------S----------------
--------------------Q-----------
------SQ------------------------
---S---------------------Q------
-----------XX-------------------
-----------XX-------------------
-----------XX-------------------
---------X-XXX----<>------------
--------X--XXXX---[]---<>---}---
----{--XXX-XXXXX--[]---[]---X---
XXXXXXXXXXXXXXXXXXXXXXXXXXXXXXXX
