--------------------------------
--------------------------------
------QS------------------------
-------------------------Q------
------------S-SS--S-------------
--------------------------------
---------Q----------------Q-----
---Q---------XX-----------------
------------XXX------------S----
-----------XXXX----S------------
------<>---XXXX-------S---------
------[]---XXXXX---------XX--}--
---{--[]--XXXXXXX--------XX--X--
XXXXXXXXXXXXXXXXXX------XXXXXXXX
