--------------------------------
--------------------------------
--------------------------------
--------------------------------
--------------------------------
--------------------------------
----------------SS--------------
--------------------------------
--------------------Q-----X-----
---SSS-------------------XX-----
-----------S------------XXX-----
----------------<>--<>-XXXX-----
---{------------[]--[]XXXXX-----
XXXXXX-----XXXXXXXXXXXXXXXXXXXXX
