--------------------------------
--------------------------------
--------------------------------
--------------------------------
--------------------------------
--------------------------------
--------------------------------
-----------------------------S--
--------------------------------
--------------------------------
-----X--Q--<>-----------X-------
-----XX----[]-------<>-XX----}--
--{--XX----[]-------[]XXX----X--
XXXXXXX--XXXXX----XXXXXXXX-XXXXX
