--------------------------------
--------------------------------
---Q----------------------------
------------S-------------------
------------------Q-------------
---SS------------------Q---Q----
--------------------------------
S-----------------SQQ-----------
----Q-------S----------------S--
--------------------------------
---------------------X---S------
-----<>-----X----<>-X--------}--
-----[]----XX----[]XXX-------X--
XXXXXXXXXXXXX--XXXXXXXX----XXXXX
