--------------------------------
--------------------------------
--------------------------------
--------------------------------
--------------------------------
------S-------------------------
--------------------------------
-------------SSQ----------------
-----------S--------------------
-----------------------XX-------
--------------<>----X-XXX-------
-----<>-X-----------X-XXX----}--
--{--[]XX------]---XXXXXXX---X--
XXXXXXXXX---XXXXXXXXXXXXXXXXXXXX
