--------------------------------
--------------------------------
--------------------------------
-----------------S--------------
---Q-----------------S----------
--------------------------------
------S--------SQ---------------
------------Q-------------------
--------S-----------------------
--SQ----------------------------
-------------------------X------
--------------->---XX---XX------
---{--X--{----[]---XX--XXXX-----
XXXX--X->XXXXXXXXXXXXXXXXXXXXXXX
