--------------------------------
--------------------------------
--------------------------------
--------------------------------
---------------S--S-------------
--------------------------------
----------------------S---------
-------------SQSQ---------------
-----------S--------------------
-------------------X------Q-----
---------SQ-------X---XX--------
-----<>----------XXX--XX-----}--
--{--[]---------XXXX--XXX----X--
XXXXXXXXX---XXXXXXXX--XXX-XXXXXX
