--------------------------------
--------------------------------
--------------------------------
--------------------------------
--------------------------------
--------------------------------
--------------------------------
--------------------------S-----
--------------------------------
--------------------------------
--------------XX-X----<>--------
--------XX---XXX------[]----}---
---{---XXX--XXXX------[]----X---
XXXXXXXXXXXXXXXXXX-XXXXXXXXXXXXX
