--------------------------------
--------------------------------
--------------------------------
--------------------------------
--------------------------------
--------------------------------
--------------------------------
--------------SQ----------------
--------------------------------
--------------------------------
---------------------XX---------
-----<>------------>-XX---}-----
--{--[]-----------[-XXXX--X-----
XXXXXXX---------XXXXXXXXXXXXXXXX
