--------------------------------
--------------------------------
--------------------------------
--------------------------------
--------------------------------
--------------------------------
--------------------------------
--------------------------------
--------------------------------
--SQ----------------------------
---------<>---------------------
------X--[]------------XX---}---
---{--X--[]--------X---XXX--X---
XXXXXXXXXXXXXXXXXXXXXXXXXXXXXXXX
