--------------------------------
--------------------------------
--------------------------------
--------------------------------
--------------------S----Q--SQ--
-----------------------------S--
--------------------------------
----------------S-Q------------S
-------------------------SSQSS--
--------------------------------
----------------X--<>--Q--------
--------->-----XX--[]------}----
----{---[]--[]XXX--[]------X----
XXXXXXXXXXXXXXXXXXXXXXX---XXXXXX
