--------------------------------
--------------------------------
--------------------------------
--------------------------------
--------------------------------
--------------------------------
--------------------------------
--------------------------------
--------------------------------
--------------------------------
---------------------<>---------
-----<>------X---<>--[]------}--
--{--[]-----XXX--[]--[]------X--
XXXXXXXXXXXXXXXXXXXXXXXXXXXXXXXX
