--------------------------------
--------------------------------
--------------------------------
--------------------------------
--------------------------------
--------------------------------
--------------------------------
--------------------------------
--------------------------------
--------------------------------
------------XXXX-----<>---------
-----<>----XXXXX-<>--[]------}--
--{--[]---XXXXXX-[]--[]------X--
XXXXXXXXXXXXXXXXXXXXXXXXXX>XXXXX
