--------------------------------
--------------------------------
--------------------------------
--------------------------------
--------------------------------
--------------------------------
-------------------S------------
--------------SQ----------------
--------------------------------
----------------------XX--------
----------<----------XXXX-------
-----<>---X]---------XXXX----}--
--{--[]---[]------[-XXXX--X--X--
XXXXXXXXXXXXX---XXXXXXXXXXXXXXXX
