--------------------------------
--------------------------------
--------------------------------
--------------------------------
---------------S--Q-------------
--------------------------------
--------------------SS----Q-----
--------------------------S-----
--------------------------------
-------------XX--X--------------
-----<>-----XXX--X----<>--S-----
-----[]--->-XXX--XX---[]-----}--
--{--[]--[]XXXX--XXX--[]-----X--
XXXXXXXXXXXXXXX--XXXXXXXXXXXXXXX
