--------------------------------
--------------------------------
--------------------------------
--------------------------------
--------------------------------
------SSS-S---------------------
--------------------------------
--------------------------------
--Q--------S---------------S----
--------------------------------
-------------------<>-----------
-----<>-X-----XX---[]------}----
--{--[]XXX---XXX---[]------X----
XXXXXXXXXXXXXXXXXXXXXXXXXXXXXXXX
