--------------------------------
--------------------------------
--------------------------------
--------------------------------
--------------------------------
--------------------------------
-------------------S------------
--------------SS----------------
--------------------------------
---------------------XX---------
---------------------XXX--------
-----<>----S--------XXXXX----}--
--{--[]---------XXX-XXXX-----X--
XXXXXXXX--------XXXXXXXXXXXXXXXX
