--------------------------------
--------------------------------
--------------------------------
--------------------------------
--------------------------------
-----SSSSQSQ--------------------
------------Q-------------------
-->-----------------------------
--QS--S----S--------------------
--------------------------------
--------------<>----------------
-----<>-XX----[]-----<>---}-----
--{--[]XXX-{--[]-----[----X-----
XXXXXXXXXXXXXXXXXXXXXXXXXXXXXXXX
