--------------------------------
--------------------------------
--------------------------------
--SS----------------------------
---Q----------------S----Q------
-X---------------------------S--
>-------------------------------
---------Q------S-Q------------S
>------------------------SSQ-S--
--------------------------------
-------------------<>--S--------
--------->----->---[]------}----
--X-----[{--[]X]---[]------XX---
XXXX--XX>XXXXXXXXXXXXXXX-XXXXXXX
