--------------------------------
--------------------------------
--------------------------------
--------------------------------
--------------------------------
------SSS-----------------------
--------------------------------
-------------SS-----------------
--Q--------S------------X-------
-----------------------XX-------
--------------<>-----XXXX-------
-----<>-X-----[]-----XXXXX---}--
--{--[]XXX----[]----XXXXXX---X--
XXXXXXXXXX-XXXXXXXXXXXXXXXXXXXXX
