--------------------------------
--------------------------------
--------------------------------
--------------------------------
--------------------------------
---------------------------S----
--------------------------------
--------------------------------
-----------------------------X--
--------------------------------
---------------XX--<>>----------
-----------<>-XXX--[]]--[--<----
----{------[]XXXX--[]-----------
XXXXXXXXXXXXXXXXXXXXXXXXXXXXX---
